01/01/2020,OMN,FL,ASO,ES,Federal Contract Tower,0,0,3,0,3,0,0,32,0,32,0,0,35,0,35,44,0,44,79
01/02/2020,OMN,FL,ASO,ES,Federal Contract Tower,0,0,15,0,15,0,0,213,0,213,0,0,228,0,228,238,0,238,466
01/03/2020,OMN,FL,ASO,ES,Federal Contract Tower,0,0,11,0,11,0,0,65,0,65,0,0,76,0,76,104,0,104,180
01/04/2020,OMN,FL,ASO,ES,Federal Contract Tower,0,0,7,0,7,0,0,6,0,6,0,0,13,0,13,0,0,0,13
01/05/2020,OMN,FL,ASO,ES,Federal Contract Tower,0,0,14,0,14,0,0,172,0,172,0,0,186,0,186,238,0,238,424
01/06/2020,OMN,FL,ASO,ES,Federal Contract Tower,0,0,16,0,16,0,0,210,0,210,0,0,226,0,226,328,0,328,554
01/07/2020,OMN,FL,ASO,ES,Federal Contract Tower,0,0,10,0,10,0,0,274,0,274,0,0,284,0,284,306,0,306,590
01/08/2020,OMN,FL,ASO,ES,Federal Contract Tower,0,0,17,0,17,0,0,264,0,264,0,0,281,0,281,228,0,228,509
01/09/2020,OMN,FL,ASO,ES,Federal Contract Tower,0,0,14,0,14,0,0,171,0,171,0,0,185,0,185,294,0,294,479
01/10/2020,OMN,FL,ASO,ES,Federal Contract Tower,0,0,17,0,17,0,0,142,0,142,0,0,159,0,159,178,0,178,337
01/11/2020,OMN,FL,ASO,ES,Federal Contract Tower,0,0,4,0,4,0,0,70,0,70,0,0,74,0,74,134,0,134,208
01/12/2020,OMN,FL,ASO,ES,Federal Contract Tower,0,0,17,0,17,0,0,67,0,67,0,0,84,0,84,130,0,130,214
01/13/2020,OMN,FL,ASO,ES,Federal Contract Tower,0,0,8,0,8,0,0,152,0,152,0,0,160,0,160,436,0,436,596
01/14/2020,OMN,FL,ASO,ES,Federal Contract Tower,0,0,20,0,20,0,0,194,0,194,0,0,214,0,214,278,0,278,492
01/15/2020,OMN,FL,ASO,ES,Federal Contract Tower,0,0,14,0,14,0,0,292,0,292,0,0,306,0,306,328,0,328,634
01/16/2020,OMN,FL,ASO,ES,Federal Contract Tower,0,0,6,0,6,0,0,157,0,157,0,0,163,0,163,334,0,334,497
01/17/2020,OMN,FL,ASO,ES,Federal Contract Tower,0,0,10,0,10,0,0,78,0,78,0,0,88,0,88,122,0,122,210
01/18/2020,OMN,FL,ASO,ES,Federal Contract Tower,0,0,12,0,12,0,0,113,0,113,0,0,125,0,125,158,0,158,283
01/19/2020,OMN,FL,ASO,ES,Federal Contract Tower,0,0,5,0,5,0,0,66,0,66,0,0,71,0,71,152,0,152,223
01/20/2020,OMN,FL,ASO,ES,Federal Contract Tower,0,0,8,0,8,0,0,124,0,124,0,0,132,0,132,350,0,350,482
01/21/2020,OMN,FL,ASO,ES,Federal Contract Tower,0,0,3,0,3,0,0,124,0,124,0,0,127,0,127,137,0,137,264
01/22/2020,OMN,FL,ASO,ES,Federal Contract Tower,0,0,2,0,2,0,0,18,0,18,0,0,20,0,20,2,0,2,22
01/23/2020,OMN,FL,ASO,ES,Federal Contract Tower,0,0,14,0,14,0,0,103,0,103,0,0,117,0,117,290,0,290,407
01/24/2020,OMN,FL,ASO,ES,Federal Contract Tower,0,0,12,0,12,0,0,199,0,199,0,0,211,0,211,410,0,410,621
01/25/2020,OMN,FL,ASO,ES,Federal Contract Tower,0,0,12,0,12,0,0,216,0,216,0,0,228,0,228,316,0,316,544
01/26/2020,OMN,FL,ASO,ES,Federal Contract Tower,0,0,13,0,13,0,0,116,0,116,0,0,129,0,129,204,0,204,333
01/27/2020,OMN,FL,ASO,ES,Federal Contract Tower,0,0,18,0,18,0,0,221,0,221,0,0,239,0,239,342,0,342,581
01/28/2020,OMN,FL,ASO,ES,Federal Contract Tower,0,0,24,0,24,0,0,248,0,248,0,0,272,0,272,351,0,351,623
01/29/2020,OMN,FL,ASO,ES,Federal Contract Tower,0,0,15,0,15,0,0,248,0,248,0,0,263,0,263,442,0,442,705
01/30/2020,OMN,FL,ASO,ES,Federal Contract Tower,0,0,7,0,7,0,0,26,0,26,0,0,33,0,33,28,0,28,61
01/31/2020,OMN,FL,ASO,ES,Federal Contract Tower,0,0,25,0,25,0,0,183,0,183,0,0,208,0,208,358,0,358,566
02/01/2020,OMN,FL,ASO,ES,Federal Contract Tower,0,0,8,0,8,0,0,7,0,7,0,0,15,0,15,2,0,2,17
02/02/2020,OMN,FL,ASO,ES,Federal Contract Tower,0,0,9,0,9,0,0,152,0,152,0,0,161,0,161,188,0,188,349
02/03/2020,OMN,FL,ASO,ES,Federal Contract Tower,0,0,17,0,17,0,0,188,0,188,0,0,205,0,205,271,0,271,476
02/04/2020,OMN,FL,ASO,ES,Federal Contract Tower,0,0,18,0,18,0,0,257,0,257,0,0,275,0,275,390,0,390,665
02/05/2020,OMN,FL,ASO,ES,Federal Contract Tower,0,0,8,0,8,0,0,321,0,321,0,0,329,0,329,290,0,290,619
02/06/2020,OMN,FL,ASO,ES,Federal Contract Tower,0,0,3,0,3,0,0,17,0,17,0,0,20,0,20,14,0,14,34
02/07/2020,OMN,FL,ASO,ES,Federal Contract Tower,0,0,5,0,5,0,0,39,0,39,0,0,44,0,44,146,0,146,190
02/08/2020,OMN,FL,ASO,ES,Federal Contract Tower,0,0,24,0,24,0,0,237,0,237,0,0,261,0,261,314,0,314,575
02/09/2020,OMN,FL,ASO,ES,Federal Contract Tower,0,0,10,0,10,0,0,125,0,125,0,0,135,0,135,238,0,238,373
02/10/2020,OMN,FL,ASO,ES,Federal Contract Tower,0,0,14,0,14,0,0,164,0,164,0,0,178,0,178,328,0,328,506
02/11/2020,OMN,FL,ASO,ES,Federal Contract Tower,0,0,20,0,20,0,0,173,0,173,0,0,193,0,193,219,0,219,412
02/12/2020,OMN,FL,ASO,ES,Federal Contract Tower,0,0,14,0,14,0,0,169,0,169,0,0,183,0,183,280,0,280,463
02/13/2020,OMN,FL,ASO,ES,Federal Contract Tower,0,0,12,0,12,0,0,88,0,88,0,0,100,0,100,70,0,70,170
02/14/2020,OMN,FL,ASO,ES,Federal Contract Tower,0,0,14,0,14,0,0,12,0,12,0,0,26,0,26,24,0,24,50
02/15/2020,OMN,FL,ASO,ES,Federal Contract Tower,0,0,20,0,20,0,0,119,0,119,0,0,139,0,139,52,0,52,191
02/16/2020,OMN,FL,ASO,ES,Federal Contract Tower,0,0,2,0,2,0,0,13,0,13,0,0,15,0,15,4,0,4,19
02/17/2020,OMN,FL,ASO,ES,Federal Contract Tower,0,0,18,0,18,0,0,121,0,121,0,0,139,0,139,296,0,296,435
02/18/2020,OMN,FL,ASO,ES,Federal Contract Tower,0,0,19,0,19,0,0,201,0,201,0,0,220,0,220,376,0,376,596
02/19/2020,OMN,FL,ASO,ES,Federal Contract Tower,0,0,22,0,22,0,0,283,0,283,0,0,305,0,305,396,0,396,701
02/20/2020,OMN,FL,ASO,ES,Federal Contract Tower,0,0,11,0,11,0,0,3,0,3,0,0,14,0,14,8,0,8,22
02/21/2020,OMN,FL,ASO,ES,Federal Contract Tower,0,0,1,0,1,0,0,2,0,2,0,0,3,0,3,8,0,8,11
02/22/2020,OMN,FL,ASO,ES,Federal Contract Tower,0,0,10,0,10,0,0,90,0,90,0,0,100,0,100,91,0,91,191
02/23/2020,OMN,FL,ASO,ES,Federal Contract Tower,0,0,11,0,11,0,0,157,0,157,0,0,168,0,168,294,0,294,462
02/24/2020,OMN,FL,ASO,ES,Federal Contract Tower,0,0,20,0,20,0,0,206,0,206,0,0,226,0,226,475,0,475,701
02/25/2020,OMN,FL,ASO,ES,Federal Contract Tower,0,0,10,0,10,0,0,223,0,223,0,0,233,0,233,328,0,328,561
02/26/2020,OMN,FL,ASO,ES,Federal Contract Tower,0,0,15,0,15,0,0,127,0,127,0,0,142,0,142,176,0,176,318
02/27/2020,OMN,FL,ASO,ES,Federal Contract Tower,0,0,18,0,18,0,0,204,0,204,0,0,222,0,222,332,0,332,554
02/28/2020,OMN,FL,ASO,ES,Federal Contract Tower,0,0,21,0,21,0,0,178,0,178,0,0,199,0,199,417,0,417,616
02/29/2020,OMN,FL,ASO,ES,Federal Contract Tower,0,0,18,0,18,0,0,145,0,145,0,0,163,0,163,148,0,148,311
03/01/2020,OMN,FL,ASO,ES,Federal Contract Tower,0,0,14,0,14,0,0,138,0,138,0,0,152,0,152,312,0,312,464
03/02/2020,OMN,FL,ASO,ES,Federal Contract Tower,0,0,17,0,17,0,0,225,0,225,0,0,242,0,242,488,0,488,730
03/03/2020,OMN,FL,ASO,ES,Federal Contract Tower,0,0,21,0,21,0,0,225,0,225,0,0,246,0,246,310,0,310,556
03/04/2020,OMN,FL,ASO,ES,Federal Contract Tower,0,0,17,0,17,0,0,289,0,289,0,0,306,0,306,368,0,368,674
03/05/2020,OMN,FL,ASO,ES,Federal Contract Tower,0,0,16,0,16,0,0,84,0,84,0,0,100,0,100,92,0,92,192
03/06/2020,OMN,FL,ASO,ES,Federal Contract Tower,0,0,24,0,24,0,0,112,0,112,0,0,136,0,136,338,0,338,474
03/07/2020,OMN,FL,ASO,ES,Federal Contract Tower,0,0,12,0,12,0,0,66,0,66,0,0,78,0,78,12,0,12,90
03/08/2020,OMN,FL,ASO,ES,Federal Contract Tower,0,0,7,0,7,0,0,117,0,117,0,0,124,0,124,140,0,140,264
03/09/2020,OMN,FL,ASO,ES,Federal Contract Tower,0,0,23,0,23,0,0,175,0,175,0,0,198,0,198,280,0,280,478
03/10/2020,OMN,FL,ASO,ES,Federal Contract Tower,0,0,21,0,21,0,0,228,0,228,0,0,249,0,249,288,0,288,537
03/11/2020,OMN,FL,ASO,ES,Federal Contract Tower,0,0,17,0,17,0,0,298,0,298,0,0,315,0,315,336,0,336,651
03/12/2020,OMN,FL,ASO,ES,Federal Contract Tower,0,0,20,0,20,0,0,222,0,222,0,0,242,0,242,450,0,450,692
03/13/2020,OMN,FL,ASO,ES,Federal Contract Tower,0,0,24,0,24,0,0,243,0,243,0,0,267,0,267,415,0,415,682
03/14/2020,OMN,FL,ASO,ES,Federal Contract Tower,0,0,14,0,14,0,0,199,0,199,0,0,213,0,213,332,0,332,545
03/15/2020,OMN,FL,ASO,ES,Federal Contract Tower,0,0,8,0,8,0,0,62,0,62,0,0,70,0,70,122,0,122,192
03/16/2020,OMN,FL,ASO,ES,Federal Contract Tower,0,0,21,0,21,0,0,121,0,121,0,0,142,0,142,230,0,230,372
03/17/2020,OMN,FL,ASO,ES,Federal Contract Tower,0,0,19,0,19,0,0,235,0,235,0,0,254,0,254,298,0,298,552
03/18/2020,OMN,FL,ASO,ES,Federal Contract Tower,0,0,20,0,20,0,0,249,0,249,0,0,269,0,269,302,0,302,571
03/19/2020,OMN,FL,ASO,ES,Federal Contract Tower,0,0,27,0,27,0,0,144,0,144,0,0,171,0,171,300,0,300,471
03/20/2020,OMN,FL,ASO,ES,Federal Contract Tower,0,0,20,0,20,0,0,185,0,185,0,0,205,0,205,418,0,418,623
03/21/2020,OMN,FL,ASO,ES,Federal Contract Tower,0,0,12,0,12,0,0,199,0,199,0,0,211,0,211,344,0,344,555
03/22/2020,OMN,FL,ASO,ES,Federal Contract Tower,0,0,10,0,10,0,0,83,0,83,0,0,93,0,93,152,0,152,245
03/23/2020,OMN,FL,ASO,ES,Federal Contract Tower,0,0,14,0,14,0,0,169,0,169,0,0,183,0,183,320,0,320,503
03/24/2020,OMN,FL,ASO,ES,Federal Contract Tower,0,0,19,0,19,0,0,202,0,202,0,0,221,0,221,298,0,298,519
03/25/2020,OMN,FL,ASO,ES,Federal Contract Tower,0,0,9,0,9,0,0,65,0,65,0,0,74,0,74,218,0,218,292
03/26/2020,OMN,FL,ASO,ES,Federal Contract Tower,0,0,23,0,23,0,0,42,0,42,0,0,65,0,65,107,0,107,172
03/27/2020,OMN,FL,ASO,ES,Federal Contract Tower,0,0,11,0,11,0,0,130,0,130,0,0,141,0,141,384,0,384,525
03/28/2020,OMN,FL,ASO,ES,Federal Contract Tower,0,0,11,0,11,0,0,191,0,191,0,0,202,0,202,198,0,198,400
03/29/2020,OMN,FL,ASO,ES,Federal Contract Tower,0,0,3,0,3,0,0,121,0,121,0,0,124,0,124,180,0,180,304
03/30/2020,OMN,FL,ASO,ES,Federal Contract Tower,0,0,5,0,5,0,0,170,0,170,0,0,175,0,175,346,0,346,521
03/31/2020,OMN,FL,ASO,ES,Federal Contract Tower,0,0,6,0,6,0,0,136,0,136,0,0,142,0,142,160,0,160,302
04/01/2020,OMN,FL,ASO,ES,Federal Contract Tower,0,0,5,0,5,0,0,192,0,192,0,0,197,0,197,312,0,312,509
04/02/2020,OMN,FL,ASO,ES,Federal Contract Tower,0,0,4,0,4,0,0,182,0,182,0,0,186,0,186,180,0,180,366
04/03/2020,OMN,FL,ASO,ES,Federal Contract Tower,0,0,3,0,3,0,0,61,0,61,0,0,64,0,64,180,0,180,244
04/04/2020,OMN,FL,ASO,ES,Federal Contract Tower,0,0,3,0,3,0,0,70,0,70,0,0,73,0,73,114,0,114,187
04/05/2020,OMN,FL,ASO,ES,Federal Contract Tower,0,0,3,0,3,0,0,4,0,4,0,0,7,0,7,2,0,2,9
04/06/2020,OMN,FL,ASO,ES,Federal Contract Tower,0,0,5,0,5,0,0,39,0,39,0,0,44,0,44,82,0,82,126
04/07/2020,OMN,FL,ASO,ES,Federal Contract Tower,0,0,5,0,5,0,0,77,0,77,0,0,82,0,82,138,0,138,220
04/08/2020,OMN,FL,ASO,ES,Federal Contract Tower,0,0,4,0,4,0,0,54,0,54,0,0,58,0,58,150,0,150,208
04/09/2020,OMN,FL,ASO,ES,Federal Contract Tower,0,0,5,0,5,0,0,23,0,23,0,0,28,0,28,44,0,44,72
04/10/2020,OMN,FL,ASO,ES,Federal Contract Tower,0,0,3,0,3,0,0,29,0,29,0,0,32,0,32,138,0,138,170
04/11/2020,OMN,FL,ASO,ES,Federal Contract Tower,0,0,10,0,10,0,0,95,0,95,0,0,105,0,105,150,0,150,255
04/12/2020,OMN,FL,ASO,ES,Federal Contract Tower,0,0,1,0,1,0,0,14,0,14,0,0,15,0,15,6,0,6,21
04/13/2020,OMN,FL,ASO,ES,Federal Contract Tower,0,0,0,0,0,0,0,25,0,25,0,0,25,0,25,22,0,22,47
04/14/2020,OMN,FL,ASO,ES,Federal Contract Tower,0,0,6,0,6,0,0,22,0,22,0,0,28,0,28,48,0,48,76
04/15/2020,OMN,FL,ASO,ES,Federal Contract Tower,0,0,1,0,1,0,0,19,0,19,0,0,20,0,20,18,0,18,38
04/16/2020,OMN,FL,ASO,ES,Federal Contract Tower,0,0,3,0,3,0,0,5,0,5,0,0,8,0,8,8,0,8,16
04/17/2020,OMN,FL,ASO,ES,Federal Contract Tower,0,0,2,0,2,0,0,21,0,21,0,0,23,0,23,44,0,44,67
04/18/2020,OMN,FL,ASO,ES,Federal Contract Tower,0,0,0,0,0,0,0,18,0,18,0,0,18,0,18,110,0,110,128
04/19/2020,OMN,FL,ASO,ES,Federal Contract Tower,0,0,6,0,6,0,0,81,0,81,0,0,87,0,87,126,0,126,213
04/20/2020,OMN,FL,ASO,ES,Federal Contract Tower,0,0,0,0,0,0,0,0,0,0,0,0,0,0,0,0,0,0,0
04/21/2020,OMN,FL,ASO,ES,Federal Contract Tower,0,0,12,0,12,0,0,148,0,148,0,0,160,0,160,258,0,258,418
04/22/2020,OMN,FL,ASO,ES,Federal Contract Tower,0,0,6,0,6,0,0,140,0,140,0,0,146,0,146,176,0,176,322
04/23/2020,OMN,FL,ASO,ES,Federal Contract Tower,0,0,2,0,2,0,0,90,0,90,0,0,92,0,92,102,0,102,194
04/24/2020,OMN,FL,ASO,ES,Federal Contract Tower,0,0,0,0,0,0,0,0,0,0,0,0,0,0,0,0,0,0,0
04/25/2020,OMN,FL,ASO,ES,Federal Contract Tower,0,0,4,0,4,0,0,34,0,34,0,0,38,0,38,154,0,154,192
04/26/2020,OMN,FL,ASO,ES,Federal Contract Tower,0,0,10,0,10,0,0,48,0,48,0,0,58,0,58,156,0,156,214
04/27/2020,OMN,FL,ASO,ES,Federal Contract Tower,0,0,8,0,8,0,0,69,0,69,0,0,77,0,77,289,0,289,366
04/28/2020,OMN,FL,ASO,ES,Federal Contract Tower,0,0,5,0,5,0,0,141,0,141,0,0,146,0,146,269,0,269,415
04/29/2020,OMN,FL,ASO,ES,Federal Contract Tower,0,0,3,0,3,0,0,70,0,70,0,0,73,0,73,152,0,152,225
04/30/2020,OMN,FL,ASO,ES,Federal Contract Tower,0,0,2,0,2,0,0,10,0,10,0,0,12,0,12,50,0,50,62
05/01/2020,OMN,FL,ASO,ES,Federal Contract Tower,0,0,11,0,11,0,0,169,0,169,0,0,180,0,180,220,0,220,400
05/02/2020,OMN,FL,ASO,ES,Federal Contract Tower,0,0,8,0,8,0,0,145,0,145,0,0,153,0,153,158,0,158,311
05/03/2020,OMN,FL,ASO,ES,Federal Contract Tower,0,0,8,0,8,0,0,82,0,82,0,0,90,0,90,134,0,134,224
05/04/2020,OMN,FL,ASO,ES,Federal Contract Tower,0,0,15,0,15,0,0,156,0,156,0,0,171,0,171,336,0,336,507
05/05/2020,OMN,FL,ASO,ES,Federal Contract Tower,0,0,8,0,8,0,0,189,0,189,0,0,197,0,197,196,0,196,393
05/06/2020,OMN,FL,ASO,ES,Federal Contract Tower,0,0,19,0,19,0,0,194,0,194,0,0,213,0,213,210,0,210,423
05/07/2020,OMN,FL,ASO,ES,Federal Contract Tower,0,0,15,0,15,0,0,189,0,189,0,0,204,0,204,222,0,222,426
05/08/2020,OMN,FL,ASO,ES,Federal Contract Tower,0,0,7,0,7,0,0,141,0,141,0,0,148,0,148,254,0,254,402
05/09/2020,OMN,FL,ASO,ES,Federal Contract Tower,0,0,9,0,9,0,0,97,0,97,0,0,106,0,106,158,0,158,264
05/10/2020,OMN,FL,ASO,ES,Federal Contract Tower,0,0,2,0,2,0,0,3,0,3,0,0,5,0,5,22,0,22,27
05/11/2020,OMN,FL,ASO,ES,Federal Contract Tower,0,0,11,0,11,0,0,132,0,132,0,0,143,0,143,252,0,252,395
05/12/2020,OMN,FL,ASO,ES,Federal Contract Tower,0,0,9,0,9,0,0,192,0,192,0,0,201,0,201,262,4,266,467
05/13/2020,OMN,FL,ASO,ES,Federal Contract Tower,0,0,14,0,14,0,0,186,0,186,0,0,200,0,200,252,0,252,452
05/14/2020,OMN,FL,ASO,ES,Federal Contract Tower,0,0,18,0,18,0,0,61,0,61,0,0,79,0,79,132,0,132,211
05/15/2020,OMN,FL,ASO,ES,Federal Contract Tower,0,0,14,0,14,0,0,101,0,101,0,0,115,0,115,142,0,142,257
05/16/2020,OMN,FL,ASO,ES,Federal Contract Tower,0,0,9,0,9,0,0,48,0,48,0,0,57,0,57,29,0,29,86
05/17/2020,OMN,FL,ASO,ES,Federal Contract Tower,0,0,10,0,10,0,0,24,0,24,0,0,34,0,34,70,0,70,104
05/18/2020,OMN,FL,ASO,ES,Federal Contract Tower,0,0,8,0,8,0,0,120,0,120,0,0,128,0,128,282,0,282,410
05/19/2020,OMN,FL,ASO,ES,Federal Contract Tower,0,0,17,0,17,0,0,140,0,140,0,0,157,0,157,252,0,252,409
05/20/2020,OMN,FL,ASO,ES,Federal Contract Tower,0,0,17,0,17,0,0,243,0,243,0,0,260,0,260,294,0,294,554
05/21/2020,OMN,FL,ASO,ES,Federal Contract Tower,0,0,18,0,18,0,0,189,0,189,0,0,207,0,207,322,0,322,529
05/22/2020,OMN,FL,ASO,ES,Federal Contract Tower,0,0,15,0,15,0,0,157,0,157,0,0,172,0,172,262,0,262,434
05/23/2020,OMN,FL,ASO,ES,Federal Contract Tower,0,0,13,0,13,0,0,95,0,95,0,0,108,0,108,164,0,164,272
05/24/2020,OMN,FL,ASO,ES,Federal Contract Tower,0,0,6,0,6,0,0,57,0,57,0,0,63,0,63,76,0,76,139
05/25/2020,OMN,FL,ASO,ES,Federal Contract Tower,0,0,13,0,13,0,0,53,0,53,0,0,66,0,66,90,0,90,156
05/26/2020,OMN,FL,ASO,ES,Federal Contract Tower,0,0,12,0,12,0,0,4,0,4,0,0,16,0,16,20,0,20,36
05/27/2020,OMN,FL,ASO,ES,Federal Contract Tower,0,0,11,0,11,0,0,47,0,47,0,0,58,0,58,106,0,106,164
05/28/2020,OMN,FL,ASO,ES,Federal Contract Tower,0,0,14,0,14,0,0,116,0,116,0,0,130,0,130,362,0,362,492
05/29/2020,OMN,FL,ASO,ES,Federal Contract Tower,0,0,17,0,17,0,0,172,0,172,0,0,189,0,189,214,0,214,403
05/30/2020,OMN,FL,ASO,ES,Federal Contract Tower,0,0,9,0,9,0,0,73,0,73,0,0,82,0,82,100,0,100,182
05/31/2020,OMN,FL,ASO,ES,Federal Contract Tower,0,0,13,0,13,0,0,71,0,71,0,0,84,0,84,114,0,114,198
06/01/2020,OMN,FL,ASO,ES,Federal Contract Tower,0,0,23,0,23,0,0,52,0,52,0,0,75,0,75,136,0,136,211
06/02/2020,OMN,FL,ASO,ES,Federal Contract Tower,0,0,21,0,21,0,0,147,0,147,0,0,168,0,168,134,0,134,302
06/03/2020,OMN,FL,ASO,ES,Federal Contract Tower,0,0,31,0,31,0,0,207,0,207,0,0,238,0,238,338,0,338,576
06/04/2020,OMN,FL,ASO,ES,Federal Contract Tower,0,0,11,0,11,0,0,16,0,16,0,0,27,0,27,2,0,2,29
06/05/2020,OMN,FL,ASO,ES,Federal Contract Tower,0,0,22,0,22,0,0,177,0,177,0,0,199,0,199,252,0,252,451
06/06/2020,OMN,FL,ASO,ES,Federal Contract Tower,0,0,16,0,16,0,0,35,0,35,0,0,51,0,51,76,0,76,127
06/07/2020,OMN,FL,ASO,ES,Federal Contract Tower,0,0,7,0,7,0,0,7,0,7,0,0,14,0,14,18,0,18,32
06/08/2020,OMN,FL,ASO,ES,Federal Contract Tower,0,0,15,0,15,0,0,105,0,105,0,0,120,0,120,122,0,122,242
06/09/2020,OMN,FL,ASO,ES,Federal Contract Tower,0,0,23,0,23,0,0,136,0,136,0,0,159,0,159,250,0,250,409
06/10/2020,OMN,FL,ASO,ES,Federal Contract Tower,0,0,10,0,10,0,0,157,0,157,0,0,167,0,167,164,0,164,331
06/11/2020,OMN,FL,ASO,ES,Federal Contract Tower,0,0,16,0,16,0,0,126,0,126,0,0,142,0,142,244,0,244,386
06/12/2020,OMN,FL,ASO,ES,Federal Contract Tower,0,0,21,0,21,0,0,178,0,178,0,0,199,0,199,242,0,242,441
06/13/2020,OMN,FL,ASO,ES,Federal Contract Tower,0,0,5,0,5,0,0,34,0,34,0,0,39,0,39,88,0,88,127
06/14/2020,OMN,FL,ASO,ES,Federal Contract Tower,0,0,8,0,8,0,0,29,0,29,0,0,37,0,37,54,0,54,91
06/15/2020,OMN,FL,ASO,ES,Federal Contract Tower,0,0,6,0,6,0,0,139,0,139,0,0,145,0,145,246,0,246,391
06/16/2020,OMN,FL,ASO,ES,Federal Contract Tower,0,0,13,0,13,0,0,242,0,242,0,0,255,0,255,254,0,254,509
06/17/2020,OMN,FL,ASO,ES,Federal Contract Tower,0,0,18,0,18,0,0,208,0,208,0,0,226,0,226,244,0,244,470
06/18/2020,OMN,FL,ASO,ES,Federal Contract Tower,0,0,19,0,19,0,0,186,0,186,0,0,205,0,205,268,0,268,473
06/19/2020,OMN,FL,ASO,ES,Federal Contract Tower,0,0,6,0,6,0,0,73,0,73,0,0,79,0,79,164,0,164,243
06/20/2020,OMN,FL,ASO,ES,Federal Contract Tower,0,0,17,0,17,0,0,49,0,49,0,0,66,0,66,82,0,82,148
06/21/2020,OMN,FL,ASO,ES,Federal Contract Tower,0,0,12,0,12,0,0,88,0,88,0,0,100,0,100,108,0,108,208
06/22/2020,OMN,FL,ASO,ES,Federal Contract Tower,0,0,12,0,12,0,0,153,0,153,0,0,165,0,165,198,0,198,363
06/23/2020,OMN,FL,ASO,ES,Federal Contract Tower,0,0,13,0,13,0,0,115,0,115,0,0,128,0,128,182,0,182,310
06/24/2020,OMN,FL,ASO,ES,Federal Contract Tower,0,0,25,0,25,0,0,180,0,180,0,0,205,0,205,248,0,248,453
06/25/2020,OMN,FL,ASO,ES,Federal Contract Tower,0,0,18,0,18,0,0,207,0,207,0,0,225,0,225,320,0,320,545
06/26/2020,OMN,FL,ASO,ES,Federal Contract Tower,0,0,20,0,20,0,0,202,0,202,0,0,222,0,222,280,0,280,502
06/27/2020,OMN,FL,ASO,ES,Federal Contract Tower,0,0,10,0,10,0,0,166,0,166,0,0,176,0,176,166,0,166,342
06/28/2020,OMN,FL,ASO,ES,Federal Contract Tower,0,0,3,0,3,0,0,20,0,20,0,0,23,0,23,26,0,26,49
06/29/2020,OMN,FL,ASO,ES,Federal Contract Tower,0,0,11,0,11,0,0,141,0,141,0,0,152,0,152,310,0,310,462
06/30/2020,OMN,FL,ASO,ES,Federal Contract Tower,0,0,14,0,14,0,0,119,0,119,0,0,133,0,133,274,0,274,407
07/01/2020,OMN,FL,ASO,ES,Federal Contract Tower,0,0,14,0,14,0,0,169,0,169,0,0,183,0,183,140,0,140,323
07/02/2020,OMN,FL,ASO,ES,Federal Contract Tower,0,0,9,0,9,0,0,126,0,126,0,0,135,0,135,150,0,150,285
07/03/2020,OMN,FL,ASO,ES,Federal Contract Tower,0,0,12,0,12,0,0,99,0,99,0,0,111,0,111,159,0,159,270
07/04/2020,OMN,FL,ASO,ES,Federal Contract Tower,0,0,7,0,7,0,0,81,0,81,0,0,88,0,88,44,0,44,132
07/05/2020,OMN,FL,ASO,ES,Federal Contract Tower,0,0,13,0,13,0,0,26,0,26,0,0,39,0,39,58,0,58,97
07/06/2020,OMN,FL,ASO,ES,Federal Contract Tower,0,0,14,0,14,0,0,62,0,62,0,0,76,0,76,114,0,114,190
07/07/2020,OMN,FL,ASO,ES,Federal Contract Tower,0,0,12,0,12,0,0,133,0,133,0,0,145,0,145,154,0,154,299
07/08/2020,OMN,FL,ASO,ES,Federal Contract Tower,0,0,10,0,10,0,0,99,0,99,0,0,109,0,109,50,0,50,159
07/09/2020,OMN,FL,ASO,ES,Federal Contract Tower,0,0,19,0,19,0,0,158,0,158,0,0,177,0,177,250,0,250,427
07/10/2020,OMN,FL,ASO,ES,Federal Contract Tower,0,0,23,0,23,0,0,127,0,127,0,0,150,0,150,234,0,234,384
07/11/2020,OMN,FL,ASO,ES,Federal Contract Tower,0,0,11,0,11,0,0,48,0,48,0,0,59,0,59,154,0,154,213
07/12/2020,OMN,FL,ASO,ES,Federal Contract Tower,0,0,4,0,4,0,0,57,0,57,0,0,61,0,61,188,0,188,249
07/13/2020,OMN,FL,ASO,ES,Federal Contract Tower,0,0,6,0,6,0,0,117,0,117,0,0,123,0,123,200,0,200,323
07/14/2020,OMN,FL,ASO,ES,Federal Contract Tower,0,0,5,0,5,0,0,128,0,128,0,0,133,0,133,214,0,214,347
07/15/2020,OMN,FL,ASO,ES,Federal Contract Tower,0,0,8,0,8,0,0,204,0,204,0,0,212,0,212,230,0,230,442
07/16/2020,OMN,FL,ASO,ES,Federal Contract Tower,0,0,7,0,7,0,0,154,0,154,0,0,161,0,161,208,0,208,369
07/17/2020,OMN,FL,ASO,ES,Federal Contract Tower,0,0,12,0,12,0,0,119,0,119,0,0,131,0,131,164,0,164,295
07/18/2020,OMN,FL,ASO,ES,Federal Contract Tower,0,0,17,0,17,0,0,73,0,73,0,0,90,0,90,86,0,86,176
07/19/2020,OMN,FL,ASO,ES,Federal Contract Tower,0,0,10,0,10,0,0,54,0,54,0,0,64,0,64,68,0,68,132
07/20/2020,OMN,FL,ASO,ES,Federal Contract Tower,0,0,12,0,12,0,0,94,0,94,0,0,106,0,106,210,0,210,316
07/21/2020,OMN,FL,ASO,ES,Federal Contract Tower,0,0,23,0,23,0,0,74,0,74,0,0,97,0,97,192,0,192,289
07/22/2020,OMN,FL,ASO,ES,Federal Contract Tower,0,0,12,0,12,0,0,51,0,51,0,0,63,0,63,186,0,186,249
07/23/2020,OMN,FL,ASO,ES,Federal Contract Tower,0,0,12,0,12,0,0,74,0,74,0,0,86,0,86,50,0,50,136
07/24/2020,OMN,FL,ASO,ES,Federal Contract Tower,0,0,27,0,27,0,0,118,0,118,0,0,145,0,145,206,0,206,351
07/25/2020,OMN,FL,ASO,ES,Federal Contract Tower,0,0,15,0,15,0,0,174,0,174,0,0,189,0,189,102,0,102,291
07/26/2020,OMN,FL,ASO,ES,Federal Contract Tower,0,0,6,0,6,0,0,32,0,32,0,0,38,0,38,34,0,34,72
07/27/2020,OMN,FL,ASO,ES,Federal Contract Tower,0,0,15,0,15,0,0,86,0,86,0,0,101,0,101,272,0,272,373
07/28/2020,OMN,FL,ASO,ES,Federal Contract Tower,0,0,12,0,12,0,0,125,0,125,0,0,137,0,137,214,0,214,351
07/29/2020,OMN,FL,ASO,ES,Federal Contract Tower,0,0,16,0,16,0,0,160,0,160,0,0,176,0,176,172,0,172,348
07/30/2020,OMN,FL,ASO,ES,Federal Contract Tower,0,0,18,0,18,0,0,165,0,165,0,0,183,0,183,112,0,112,295
07/31/2020,OMN,FL,ASO,ES,Federal Contract Tower,0,0,26,0,26,0,0,100,0,100,0,0,126,0,126,228,0,228,354
08/01/2020,OMN,FL,ASO,ES,Federal Contract Tower,0,0,12,0,12,0,0,107,0,107,0,0,119,0,119,178,0,178,297
08/02/2020,OMN,FL,ASO,ES,Federal Contract Tower,0,0,0,0,0,0,0,0,0,0,0,0,0,0,0,0,0,0,0
08/03/2020,OMN,FL,ASO,ES,Federal Contract Tower,0,0,5,0,5,0,0,11,0,11,0,0,16,0,16,34,0,34,50
08/04/2020,OMN,FL,ASO,ES,Federal Contract Tower,0,0,14,0,14,0,0,145,0,145,0,0,159,0,159,132,0,132,291
08/05/2020,OMN,FL,ASO,ES,Federal Contract Tower,0,0,13,0,13,0,0,122,0,122,0,0,135,0,135,138,0,138,273
08/06/2020,OMN,FL,ASO,ES,Federal Contract Tower,0,0,10,0,10,0,0,155,0,155,0,0,165,0,165,212,0,212,377
08/07/2020,OMN,FL,ASO,ES,Federal Contract Tower,0,0,13,0,13,0,0,127,0,127,0,0,140,0,140,188,0,188,328
08/08/2020,OMN,FL,ASO,ES,Federal Contract Tower,0,0,13,0,13,0,0,146,0,146,0,0,159,0,159,78,0,78,237
08/09/2020,OMN,FL,ASO,ES,Federal Contract Tower,0,0,6,0,6,0,0,36,0,36,0,0,42,0,42,84,0,84,126
08/10/2020,OMN,FL,ASO,ES,Federal Contract Tower,0,0,17,0,17,0,0,105,0,105,0,0,122,0,122,224,0,224,346
08/11/2020,OMN,FL,ASO,ES,Federal Contract Tower,0,0,16,0,16,0,0,154,0,154,0,0,170,0,170,114,0,114,284
08/12/2020,OMN,FL,ASO,ES,Federal Contract Tower,0,0,20,0,20,0,0,139,0,139,0,0,159,0,159,80,0,80,239
08/13/2020,OMN,FL,ASO,ES,Federal Contract Tower,0,0,14,0,14,0,0,80,0,80,0,0,94,0,94,134,0,134,228
08/14/2020,OMN,FL,ASO,ES,Federal Contract Tower,0,0,13,0,13,0,0,120,0,120,0,0,133,0,133,148,0,148,281
08/15/2020,OMN,FL,ASO,ES,Federal Contract Tower,0,0,10,0,10,0,0,111,0,111,0,0,121,0,121,94,0,94,215
08/16/2020,OMN,FL,ASO,ES,Federal Contract Tower,0,0,1,0,1,0,0,34,0,34,0,0,35,0,35,46,0,46,81
08/17/2020,OMN,FL,ASO,ES,Federal Contract Tower,0,0,6,0,6,0,0,81,0,81,0,0,87,0,87,182,0,182,269
08/18/2020,OMN,FL,ASO,ES,Federal Contract Tower,0,0,13,0,13,0,0,94,0,94,0,0,107,0,107,128,0,128,235
08/19/2020,OMN,FL,ASO,ES,Federal Contract Tower,0,0,11,0,11,0,0,157,0,157,0,0,168,0,168,178,0,178,346
08/20/2020,OMN,FL,ASO,ES,Federal Contract Tower,0,0,13,0,13,0,0,181,0,181,0,0,194,0,194,240,0,240,434
08/21/2020,OMN,FL,ASO,ES,Federal Contract Tower,0,0,11,0,11,0,0,143,0,143,0,0,154,0,154,180,0,180,334
08/22/2020,OMN,FL,ASO,ES,Federal Contract Tower,0,0,12,0,12,0,0,58,0,58,0,0,70,0,70,82,0,82,152
08/23/2020,OMN,FL,ASO,ES,Federal Contract Tower,0,0,15,0,15,0,0,44,0,44,0,0,59,0,59,114,0,114,173
08/24/2020,OMN,FL,ASO,ES,Federal Contract Tower,0,0,9,0,9,0,0,69,0,69,0,0,78,0,78,76,0,76,154
08/25/2020,OMN,FL,ASO,ES,Federal Contract Tower,0,0,11,0,11,0,0,88,0,88,0,0,99,0,99,174,0,174,273
08/26/2020,OMN,FL,ASO,ES,Federal Contract Tower,0,2,22,0,24,0,0,126,0,126,0,2,148,0,150,188,0,188,338
08/27/2020,OMN,FL,ASO,ES,Federal Contract Tower,0,0,14,0,14,0,0,117,0,117,0,0,131,0,131,180,0,180,311
08/28/2020,OMN,FL,ASO,ES,Federal Contract Tower,0,0,26,0,26,0,0,168,0,168,0,0,194,0,194,234,0,234,428
08/29/2020,OMN,FL,ASO,ES,Federal Contract Tower,0,0,6,0,6,0,0,95,0,95,0,0,101,0,101,80,0,80,181
08/30/2020,OMN,FL,ASO,ES,Federal Contract Tower,0,0,9,0,9,0,0,6,0,6,0,0,15,0,15,22,0,22,37
08/31/2020,OMN,FL,ASO,ES,Federal Contract Tower,0,0,5,0,5,0,0,35,0,35,0,0,40,0,40,60,0,60,100
09/01/2020,OMN,FL,ASO,ES,Federal Contract Tower,0,0,20,0,20,0,0,61,0,61,0,0,81,0,81,78,0,78,159
09/02/2020,OMN,FL,ASO,ES,Federal Contract Tower,0,0,17,0,17,0,0,137,0,137,0,0,154,0,154,234,0,234,388
09/03/2020,OMN,FL,ASO,ES,Federal Contract Tower,0,0,13,0,13,0,0,113,0,113,0,0,126,0,126,160,0,160,286
09/04/2020,OMN,FL,ASO,ES,Federal Contract Tower,0,0,19,0,19,0,0,120,0,120,0,0,139,0,139,124,0,124,263
09/05/2020,OMN,FL,ASO,ES,Federal Contract Tower,0,0,18,0,18,0,0,88,0,88,0,0,106,0,106,108,0,108,214
09/06/2020,OMN,FL,ASO,ES,Federal Contract Tower,0,0,5,0,5,0,0,60,0,60,0,0,65,0,65,46,0,46,111
09/07/2020,OMN,FL,ASO,ES,Federal Contract Tower,0,0,21,0,21,0,0,30,0,30,0,0,51,0,51,118,0,118,169
09/08/2020,OMN,FL,ASO,ES,Federal Contract Tower,0,0,12,0,12,0,0,49,0,49,0,0,61,0,61,90,0,90,151
09/09/2020,OMN,FL,ASO,ES,Federal Contract Tower,0,0,21,0,21,0,0,72,0,72,0,0,93,0,93,124,0,124,217
09/10/2020,OMN,FL,ASO,ES,Federal Contract Tower,0,0,17,0,17,0,0,127,0,127,0,0,144,0,144,88,0,88,232
09/11/2020,OMN,FL,ASO,ES,Federal Contract Tower,0,0,21,0,21,0,0,41,0,41,0,0,62,0,62,56,4,60,122
09/12/2020,OMN,FL,ASO,ES,Federal Contract Tower,0,0,13,0,13,0,0,29,0,29,0,0,42,0,42,18,0,18,60
09/13/2020,OMN,FL,ASO,ES,Federal Contract Tower,0,0,3,0,3,0,0,2,0,2,0,0,5,0,5,10,0,10,15
09/14/2020,OMN,FL,ASO,ES,Federal Contract Tower,0,0,15,0,15,0,0,100,0,100,0,0,115,0,115,200,0,200,315
09/15/2020,OMN,FL,ASO,ES,Federal Contract Tower,0,0,32,0,32,0,0,119,0,119,0,0,151,0,151,160,0,160,311
09/16/2020,OMN,FL,ASO,ES,Federal Contract Tower,0,0,21,0,21,0,0,112,0,112,0,0,133,0,133,122,0,122,255
09/17/2020,OMN,FL,ASO,ES,Federal Contract Tower,0,0,10,0,10,0,0,47,0,47,0,0,57,0,57,102,0,102,159
09/18/2020,OMN,FL,ASO,ES,Federal Contract Tower,0,0,22,0,22,0,0,97,0,97,0,0,119,0,119,274,0,274,393
09/19/2020,OMN,FL,ASO,ES,Federal Contract Tower,0,0,9,0,9,0,0,53,0,53,0,0,62,0,62,52,0,52,114
09/20/2020,OMN,FL,ASO,ES,Federal Contract Tower,0,0,3,0,3,0,0,1,0,1,0,0,4,0,4,0,0,0,4
09/21/2020,OMN,FL,ASO,ES,Federal Contract Tower,0,0,5,0,5,0,0,24,0,24,0,0,29,0,29,0,0,0,29
09/22/2020,OMN,FL,ASO,ES,Federal Contract Tower,0,0,31,0,31,0,0,81,0,81,0,0,112,0,112,160,0,160,272
09/23/2020,OMN,FL,ASO,ES,Federal Contract Tower,0,0,28,0,28,0,0,158,0,158,0,0,186,0,186,284,0,284,470
09/24/2020,OMN,FL,ASO,ES,Federal Contract Tower,0,0,11,0,11,0,0,136,0,136,0,0,147,0,147,256,0,256,403
09/25/2020,OMN,FL,ASO,ES,Federal Contract Tower,0,0,21,0,21,0,0,105,0,105,0,0,126,0,126,288,0,288,414
09/26/2020,OMN,FL,ASO,ES,Federal Contract Tower,0,0,20,0,20,0,0,131,0,131,0,0,151,0,151,239,0,239,390
09/27/2020,OMN,FL,ASO,ES,Federal Contract Tower,0,0,6,0,6,0,0,35,0,35,0,0,41,0,41,98,0,98,139
09/28/2020,OMN,FL,ASO,ES,Federal Contract Tower,0,0,12,0,12,0,0,93,0,93,0,0,105,0,105,196,0,196,301
09/29/2020,OMN,FL,ASO,ES,Federal Contract Tower,0,0,5,0,5,0,0,94,0,94,0,0,99,0,99,194,0,194,293
09/30/2020,OMN,FL,ASO,ES,Federal Contract Tower,0,0,17,0,17,0,0,201,0,201,0,0,218,0,218,290,0,290,508
10/01/2020,OMN,FL,ASO,ES,Federal Contract Tower,0,0,20,0,20,0,0,161,0,161,0,0,181,0,181,252,0,252,433
10/02/2020,OMN,FL,ASO,ES,Federal Contract Tower,0,0,14,0,14,0,0,176,0,176,0,0,190,0,190,381,0,381,571
10/03/2020,OMN,FL,ASO,ES,Federal Contract Tower,0,0,12,0,12,0,0,91,0,91,0,0,103,0,103,50,0,50,153
10/04/2020,OMN,FL,ASO,ES,Federal Contract Tower,0,0,4,0,4,0,0,3,0,3,0,0,7,0,7,6,0,6,13
10/05/2020,OMN,FL,ASO,ES,Federal Contract Tower,0,0,13,0,13,0,0,42,0,42,0,0,55,0,55,80,0,80,135
10/06/2020,OMN,FL,ASO,ES,Federal Contract Tower,0,0,11,0,11,0,0,113,0,113,0,0,124,0,124,254,0,254,378
10/07/2020,OMN,FL,ASO,ES,Federal Contract Tower,0,0,12,0,12,0,0,32,0,32,0,0,44,0,44,24,0,24,68
10/08/2020,OMN,FL,ASO,ES,Federal Contract Tower,0,0,21,0,21,0,0,87,0,87,0,0,108,0,108,172,0,172,280
10/09/2020,OMN,FL,ASO,ES,Federal Contract Tower,0,0,13,0,13,0,0,78,0,78,0,0,91,0,91,130,0,130,221
10/10/2020,OMN,FL,ASO,ES,Federal Contract Tower,0,0,12,0,12,0,0,56,0,56,0,0,68,0,68,46,0,46,114
10/11/2020,OMN,FL,ASO,ES,Federal Contract Tower,0,0,12,0,12,0,0,12,0,12,0,0,24,0,24,8,0,8,32
10/12/2020,OMN,FL,ASO,ES,Federal Contract Tower,0,0,24,0,24,0,0,94,0,94,0,0,118,0,118,226,0,226,344
10/13/2020,OMN,FL,ASO,ES,Federal Contract Tower,0,0,21,0,21,0,0,215,0,215,0,0,236,0,236,370,0,370,606
10/14/2020,OMN,FL,ASO,ES,Federal Contract Tower,0,0,19,0,19,0,0,214,0,214,0,0,233,0,233,252,0,252,485
10/15/2020,OMN,FL,ASO,ES,Federal Contract Tower,0,0,20,0,20,0,0,88,0,88,0,0,108,0,108,290,0,290,398
10/16/2020,OMN,FL,ASO,ES,Federal Contract Tower,0,0,26,0,26,0,0,183,0,183,0,0,209,0,209,330,0,330,539
10/17/2020,OMN,FL,ASO,ES,Federal Contract Tower,0,0,13,0,13,0,0,75,0,75,0,0,88,0,88,90,0,90,178
10/18/2020,OMN,FL,ASO,ES,Federal Contract Tower,0,0,26,0,26,0,0,16,0,16,0,0,42,0,42,32,0,32,74
10/19/2020,OMN,FL,ASO,ES,Federal Contract Tower,0,0,16,0,16,0,0,47,0,47,0,0,63,0,63,110,0,110,173
10/20/2020,OMN,FL,ASO,ES,Federal Contract Tower,0,0,17,0,17,0,0,80,0,80,0,0,97,0,97,246,0,246,343
10/21/2020,OMN,FL,ASO,ES,Federal Contract Tower,0,0,26,0,26,0,0,101,0,101,0,0,127,0,127,210,0,210,337
10/22/2020,OMN,FL,ASO,ES,Federal Contract Tower,0,0,16,0,16,0,0,80,0,80,0,0,96,0,96,160,0,160,256
10/23/2020,OMN,FL,ASO,ES,Federal Contract Tower,0,0,18,0,18,0,0,71,0,71,0,0,89,0,89,228,0,228,317
10/24/2020,OMN,FL,ASO,ES,Federal Contract Tower,0,0,19,0,19,0,0,66,0,66,0,0,85,0,85,122,0,122,207
10/25/2020,OMN,FL,ASO,ES,Federal Contract Tower,0,0,7,0,7,0,0,53,0,53,0,0,60,0,60,88,0,88,148
10/26/2020,OMN,FL,ASO,ES,Federal Contract Tower,0,0,14,0,14,0,0,84,0,84,0,0,98,0,98,404,0,404,502
10/27/2020,OMN,FL,ASO,ES,Federal Contract Tower,0,0,10,0,10,0,0,92,0,92,0,0,102,0,102,258,0,258,360
10/28/2020,OMN,FL,ASO,ES,Federal Contract Tower,0,0,20,0,20,0,0,151,0,151,0,0,171,0,171,114,0,114,285
10/29/2020,OMN,FL,ASO,ES,Federal Contract Tower,0,0,12,0,12,0,0,82,0,82,0,0,94,0,94,146,0,146,240
10/30/2020,OMN,FL,ASO,ES,Federal Contract Tower,0,0,19,0,19,0,0,147,0,147,0,0,166,0,166,319,0,319,485
10/31/2020,OMN,FL,ASO,ES,Federal Contract Tower,0,0,16,0,16,0,0,86,0,86,0,0,102,0,102,130,0,130,232
11/01/2020,OMN,FL,ASO,ES,Federal Contract Tower,0,0,11,0,11,0,0,47,0,47,0,0,58,0,58,68,0,68,126
11/02/2020,OMN,FL,ASO,ES,Federal Contract Tower,0,0,4,0,4,0,0,28,0,28,0,0,32,0,32,34,0,34,66
11/03/2020,OMN,FL,ASO,ES,Federal Contract Tower,0,0,13,0,13,0,0,153,0,153,0,0,166,0,166,324,0,324,490
11/04/2020,OMN,FL,ASO,ES,Federal Contract Tower,0,0,19,0,19,0,0,95,0,95,0,0,114,0,114,244,0,244,358
11/05/2020,OMN,FL,ASO,ES,Federal Contract Tower,0,0,14,0,14,0,0,107,0,107,0,0,121,0,121,252,0,252,373
11/06/2020,OMN,FL,ASO,ES,Federal Contract Tower,0,0,13,0,13,0,0,124,0,124,0,0,137,0,137,294,0,294,431
11/07/2020,OMN,FL,ASO,ES,Federal Contract Tower,0,0,12,0,12,0,0,41,0,41,0,0,53,0,53,86,0,86,139
11/08/2020,OMN,FL,ASO,ES,Federal Contract Tower,0,0,3,0,3,0,0,4,0,4,0,0,7,0,7,4,0,4,11
11/09/2020,OMN,FL,ASO,ES,Federal Contract Tower,0,0,4,0,4,0,0,0,0,0,0,0,4,0,4,2,0,2,6
11/10/2020,OMN,FL,ASO,ES,Federal Contract Tower,0,0,9,0,9,0,0,21,0,21,0,0,30,0,30,36,0,36,66
11/11/2020,OMN,FL,ASO,ES,Federal Contract Tower,0,0,19,0,19,0,0,7,0,7,0,0,26,0,26,24,0,24,50
11/13/2020,OMN,FL,ASO,ES,Federal Contract Tower,0,0,21,0,21,0,0,98,0,98,0,0,119,0,119,246,0,246,365
11/14/2020,OMN,FL,ASO,ES,Federal Contract Tower,0,0,25,0,25,0,0,115,0,115,0,0,140,0,140,256,0,256,396
11/15/2020,OMN,FL,ASO,ES,Federal Contract Tower,0,0,9,0,9,0,0,90,0,90,0,0,99,0,99,152,0,152,251
11/16/2020,OMN,FL,ASO,ES,Federal Contract Tower,0,0,24,0,24,0,0,195,0,195,0,0,219,0,219,320,0,320,539
11/17/2020,OMN,FL,ASO,ES,Federal Contract Tower,0,0,13,0,13,0,0,224,0,224,0,0,237,0,237,364,0,364,601
11/18/2020,OMN,FL,ASO,ES,Federal Contract Tower,0,0,9,0,9,0,0,88,0,88,0,0,97,0,97,96,0,96,193
11/19/2020,OMN,FL,ASO,ES,Federal Contract Tower,0,0,21,0,21,0,0,120,0,120,0,0,141,0,141,186,0,186,327
11/20/2020,OMN,FL,ASO,ES,Federal Contract Tower,0,0,12,0,12,0,0,203,0,203,0,0,215,0,215,242,0,242,457
11/21/2020,OMN,FL,ASO,ES,Federal Contract Tower,0,0,22,0,22,0,0,145,0,145,0,0,167,0,167,130,0,130,297
11/22/2020,OMN,FL,ASO,ES,Federal Contract Tower,0,0,2,0,2,0,0,0,0,0,0,0,2,0,2,2,0,2,4
11/23/2020,OMN,FL,ASO,ES,Federal Contract Tower,0,0,12,0,12,0,0,157,0,157,0,0,169,0,169,404,0,404,573
11/24/2020,OMN,FL,ASO,ES,Federal Contract Tower,0,0,9,0,9,0,0,166,0,166,0,0,175,0,175,298,0,298,473
11/25/2020,OMN,FL,ASO,ES,Federal Contract Tower,0,0,17,0,17,0,0,178,0,178,0,0,195,0,195,170,0,170,365
11/26/2020,OMN,FL,ASO,ES,Federal Contract Tower,0,0,4,0,4,0,0,20,0,20,0,0,24,0,24,2,0,2,26
11/27/2020,OMN,FL,ASO,ES,Federal Contract Tower,0,0,6,0,6,0,0,189,0,189,0,0,195,0,195,260,0,260,455
11/28/2020,OMN,FL,ASO,ES,Federal Contract Tower,0,0,12,0,12,0,0,146,0,146,0,0,158,0,158,126,0,126,284
11/29/2020,OMN,FL,ASO,ES,Federal Contract Tower,0,0,15,0,15,0,0,43,0,43,0,0,58,0,58,116,0,116,174
11/30/2020,OMN,FL,ASO,ES,Federal Contract Tower,0,0,14,0,14,0,0,73,0,73,0,0,87,0,87,154,0,154,241
12/01/2020,OMN,FL,ASO,ES,Federal Contract Tower,0,0,18,0,18,0,0,122,0,122,0,0,140,0,140,248,0,248,388
12/02/2020,OMN,FL,ASO,ES,Federal Contract Tower,0,0,16,0,16,0,0,240,0,240,0,0,256,0,256,250,0,250,506
12/03/2020,OMN,FL,ASO,ES,Federal Contract Tower,0,0,12,0,12,0,0,177,0,177,0,0,189,0,189,352,0,352,541
12/04/2020,OMN,FL,ASO,ES,Federal Contract Tower,0,0,5,0,5,0,0,243,0,243,0,0,248,0,248,342,0,342,590
12/05/2020,OMN,FL,ASO,ES,Federal Contract Tower,0,0,16,0,16,0,0,175,0,175,0,0,191,0,191,190,0,190,381
12/06/2020,OMN,FL,ASO,ES,Federal Contract Tower,0,0,10,0,10,0,0,92,0,92,0,0,102,0,102,198,0,198,300
12/07/2020,OMN,FL,ASO,ES,Federal Contract Tower,0,0,17,0,17,0,0,56,0,56,0,0,73,0,73,72,0,72,145
12/08/2020,OMN,FL,ASO,ES,Federal Contract Tower,0,0,10,0,10,0,0,140,0,140,0,0,150,0,150,337,0,337,487
12/09/2020,OMN,FL,ASO,ES,Federal Contract Tower,0,0,11,0,11,0,0,159,0,159,0,0,170,0,170,392,0,392,562
12/10/2020,OMN,FL,ASO,ES,Federal Contract Tower,0,0,7,0,7,0,0,174,0,174,0,0,181,0,181,256,0,256,437
12/11/2020,OMN,FL,ASO,ES,Federal Contract Tower,0,0,15,0,15,0,0,156,0,156,0,0,171,0,171,290,0,290,461
12/12/2020,OMN,FL,ASO,ES,Federal Contract Tower,0,0,9,0,9,0,0,30,0,30,0,0,39,0,39,60,0,60,99
12/13/2020,OMN,FL,ASO,ES,Federal Contract Tower,0,0,5,0,5,0,0,39,0,39,0,0,44,0,44,92,0,92,136
12/14/2020,OMN,FL,ASO,ES,Federal Contract Tower,0,0,15,0,15,0,0,83,0,83,0,0,98,0,98,74,0,74,172
12/15/2020,OMN,FL,ASO,ES,Federal Contract Tower,0,0,12,0,12,0,0,161,0,161,0,0,173,0,173,196,0,196,369
12/16/2020,OMN,FL,ASO,ES,Federal Contract Tower,0,0,7,0,7,0,0,58,0,58,0,0,65,0,65,126,0,126,191
12/17/2020,OMN,FL,ASO,ES,Federal Contract Tower,0,0,16,0,16,0,0,33,0,33,0,0,49,0,49,90,0,90,139
12/18/2020,OMN,FL,ASO,ES,Federal Contract Tower,0,0,19,0,19,0,0,166,0,166,0,0,185,0,185,296,0,296,481
12/19/2020,OMN,FL,ASO,ES,Federal Contract Tower,0,0,15,0,15,0,0,94,0,94,0,0,109,0,109,134,0,134,243
12/20/2020,OMN,FL,ASO,ES,Federal Contract Tower,0,0,3,0,3,0,0,33,0,33,0,0,36,0,36,84,0,84,120
12/21/2020,OMN,FL,ASO,ES,Federal Contract Tower,0,0,7,0,7,0,0,44,0,44,0,0,51,0,51,154,0,154,205
12/22/2020,OMN,FL,ASO,ES,Federal Contract Tower,0,0,24,0,24,0,0,114,0,114,0,0,138,0,138,164,0,164,302
12/23/2020,OMN,FL,ASO,ES,Federal Contract Tower,0,0,11,0,11,0,0,117,0,117,0,0,128,0,128,130,0,130,258
12/24/2020,OMN,FL,ASO,ES,Federal Contract Tower,0,0,5,0,5,0,0,63,0,63,0,0,68,0,68,18,0,18,86
12/25/2020,OMN,FL,ASO,ES,Federal Contract Tower,0,0,3,0,3,0,0,1,0,1,0,0,4,0,4,0,0,0,4
12/26/2020,OMN,FL,ASO,ES,Federal Contract Tower,0,0,11,0,11,0,0,43,0,43,0,0,54,0,54,64,0,64,118
12/27/2020,OMN,FL,ASO,ES,Federal Contract Tower,0,0,7,0,7,0,0,32,0,32,0,0,39,0,39,56,0,56,95
12/28/2020,OMN,FL,ASO,ES,Federal Contract Tower,0,0,17,0,17,0,0,54,0,54,0,0,71,0,71,64,0,64,135
12/29/2020,OMN,FL,ASO,ES,Federal Contract Tower,0,0,3,0,3,0,0,89,0,89,0,0,92,0,92,140,0,140,232
12/30/2020,OMN,FL,ASO,ES,Federal Contract Tower,0,0,14,0,14,0,0,72,0,72,0,0,86,0,86,20,0,20,106
12/31/2020,OMN,FL,ASO,ES,Federal Contract Tower,0,0,7,0,7,0,0,62,0,62,0,0,69,0,69,38,0,38,107
01/01/2021,OMN,FL,ASO,ES,Federal Contract Tower,0,0,2,0,2,0,0,9,0,9,0,0,11,0,11,4,0,4,15
01/02/2021,OMN,FL,ASO,ES,Federal Contract Tower,0,0,8,0,8,0,0,30,0,30,0,0,38,0,38,120,0,120,158
01/03/2021,OMN,FL,ASO,ES,Federal Contract Tower,0,0,7,0,7,0,0,7,0,7,0,0,14,0,14,26,0,26,40
01/04/2021,OMN,FL,ASO,ES,Federal Contract Tower,0,0,12,0,12,0,0,117,0,117,0,0,129,0,129,212,0,212,341
01/05/2021,OMN,FL,ASO,ES,Federal Contract Tower,0,0,14,0,14,0,0,148,0,148,0,0,162,0,162,192,0,192,354
01/06/2021,OMN,FL,ASO,ES,Federal Contract Tower,0,0,13,0,13,0,0,214,0,214,0,0,227,0,227,232,0,232,459
01/07/2021,OMN,FL,ASO,ES,Federal Contract Tower,0,0,18,0,18,0,0,131,0,131,0,0,149,0,149,294,0,294,443
01/08/2021,OMN,FL,ASO,ES,Federal Contract Tower,0,0,12,0,12,0,0,157,0,157,0,0,169,0,169,142,0,142,311
01/09/2021,OMN,FL,ASO,ES,Federal Contract Tower,0,0,11,0,11,0,0,120,0,120,0,0,131,0,131,126,0,126,257
01/10/2021,OMN,FL,ASO,ES,Federal Contract Tower,0,0,12,0,12,0,0,54,0,54,0,0,66,0,66,110,0,110,176
01/11/2021,OMN,FL,ASO,ES,Federal Contract Tower,0,0,13,0,13,0,0,121,0,121,0,0,134,0,134,272,0,272,406
01/12/2021,OMN,FL,ASO,ES,Federal Contract Tower,0,0,23,0,23,0,0,86,0,86,0,0,109,0,109,150,0,150,259
01/13/2021,OMN,FL,ASO,ES,Federal Contract Tower,0,0,14,0,14,0,0,176,0,176,0,0,190,0,190,200,0,200,390
01/14/2021,OMN,FL,ASO,ES,Federal Contract Tower,0,0,14,0,14,0,0,151,0,151,0,0,165,0,165,284,0,284,449
01/15/2021,OMN,FL,ASO,ES,Federal Contract Tower,0,0,14,0,14,0,0,103,0,103,0,0,117,0,117,312,0,312,429
01/16/2021,OMN,FL,ASO,ES,Federal Contract Tower,0,0,6,0,6,0,0,59,0,59,0,0,65,0,65,138,0,138,203
01/17/2021,OMN,FL,ASO,ES,Federal Contract Tower,0,0,3,0,3,0,0,29,0,29,0,0,32,0,32,118,0,118,150
01/18/2021,OMN,FL,ASO,ES,Federal Contract Tower,0,0,13,0,13,0,0,146,0,146,0,0,159,0,159,268,0,268,427
01/19/2021,OMN,FL,ASO,ES,Federal Contract Tower,0,0,18,0,18,0,0,144,0,144,0,0,162,0,162,292,0,292,454
01/20/2021,OMN,FL,ASO,ES,Federal Contract Tower,0,0,6,0,6,0,0,185,0,185,0,0,191,0,191,224,0,224,415
01/21/2021,OMN,FL,ASO,ES,Federal Contract Tower,0,0,16,0,16,0,0,179,0,179,0,0,195,0,195,154,0,154,349
01/22/2021,OMN,FL,ASO,ES,Federal Contract Tower,0,0,9,0,9,0,0,151,0,151,0,0,160,0,160,269,0,269,429
01/23/2021,OMN,FL,ASO,ES,Federal Contract Tower,0,0,7,0,7,0,0,5,0,5,0,0,12,0,12,18,0,18,30
01/24/2021,OMN,FL,ASO,ES,Federal Contract Tower,0,0,6,0,6,0,0,17,0,17,0,0,23,0,23,4,0,4,27
01/25/2021,OMN,FL,ASO,ES,Federal Contract Tower,0,0,11,0,11,0,0,133,0,133,0,0,144,0,144,426,0,426,570
01/26/2021,OMN,FL,ASO,ES,Federal Contract Tower,0,0,26,0,26,0,0,113,0,113,0,0,139,0,139,128,0,128,267
01/27/2021,OMN,FL,ASO,ES,Federal Contract Tower,0,0,6,0,6,0,0,58,0,58,0,0,64,0,64,84,0,84,148
01/28/2021,OMN,FL,ASO,ES,Federal Contract Tower,0,0,14,0,14,0,0,121,0,121,0,0,135,0,135,182,0,182,317
01/29/2021,OMN,FL,ASO,ES,Federal Contract Tower,0,0,12,0,12,0,0,130,0,130,0,0,142,0,142,456,0,456,598
01/30/2021,OMN,FL,ASO,ES,Federal Contract Tower,0,0,23,0,23,0,0,105,0,105,0,0,128,0,128,106,0,106,234
01/31/2021,OMN,FL,ASO,ES,Federal Contract Tower,0,0,1,0,1,0,0,72,0,72,0,0,73,0,73,128,0,128,201
02/01/2021,OMN,FL,ASO,ES,Federal Contract Tower,0,0,9,0,9,0,0,37,0,37,0,0,46,0,46,52,0,52,98
02/02/2021,OMN,FL,ASO,ES,Federal Contract Tower,0,0,5,0,5,0,0,38,0,38,0,0,43,0,43,30,0,30,73
02/03/2021,OMN,FL,ASO,ES,Federal Contract Tower,0,0,8,0,8,0,0,185,0,185,0,0,193,0,193,294,0,294,487
02/04/2021,OMN,FL,ASO,ES,Federal Contract Tower,0,0,23,0,23,0,0,186,0,186,0,0,209,0,209,348,0,348,557
02/05/2021,OMN,FL,ASO,ES,Federal Contract Tower,0,0,10,0,10,0,0,94,0,94,0,0,104,0,104,186,0,186,290
02/06/2021,OMN,FL,ASO,ES,Federal Contract Tower,0,0,5,0,5,0,0,37,0,37,0,0,42,0,42,50,0,50,92
02/07/2021,OMN,FL,ASO,ES,Federal Contract Tower,0,0,6,0,6,0,0,15,0,15,0,0,21,0,21,62,0,62,83
02/08/2021,OMN,FL,ASO,ES,Federal Contract Tower,0,0,13,0,13,0,0,120,0,120,0,0,133,0,133,224,0,224,357
02/09/2021,OMN,FL,ASO,ES,Federal Contract Tower,0,0,13,0,13,0,0,77,0,77,0,0,90,0,90,58,0,58,148
02/10/2021,OMN,FL,ASO,ES,Federal Contract Tower,0,0,7,0,7,0,0,47,0,47,0,0,54,0,54,44,0,44,98
02/11/2021,OMN,FL,ASO,ES,Federal Contract Tower,0,0,7,0,7,0,0,178,0,178,0,0,185,0,185,222,0,222,407
02/12/2021,OMN,FL,ASO,ES,Federal Contract Tower,0,0,17,0,17,0,0,90,0,90,0,0,107,0,107,374,0,374,481
02/13/2021,OMN,FL,ASO,ES,Federal Contract Tower,0,0,12,0,12,0,0,31,0,31,0,0,43,0,43,40,0,40,83
02/14/2021,OMN,FL,ASO,ES,Federal Contract Tower,0,0,2,0,2,0,0,10,0,10,0,0,12,0,12,22,0,22,34
02/15/2021,OMN,FL,ASO,ES,Federal Contract Tower,0,0,16,0,16,0,0,100,0,100,0,0,116,0,116,196,0,196,312
02/16/2021,OMN,FL,ASO,ES,Federal Contract Tower,0,0,13,0,13,0,0,167,0,167,0,0,180,0,180,316,0,316,496
02/17/2021,OMN,FL,ASO,ES,Federal Contract Tower,0,0,20,0,20,0,0,123,0,123,0,0,143,0,143,256,0,256,399
02/18/2021,OMN,FL,ASO,ES,Federal Contract Tower,0,0,13,0,13,0,0,117,0,117,0,0,130,0,130,282,0,282,412
02/19/2021,OMN,FL,ASO,ES,Federal Contract Tower,0,0,6,0,6,0,0,4,0,4,0,0,10,0,10,4,0,4,14
02/20/2021,OMN,FL,ASO,ES,Federal Contract Tower,0,0,15,0,15,0,0,179,0,179,0,0,194,0,194,316,0,316,510
02/21/2021,OMN,FL,ASO,ES,Federal Contract Tower,0,0,12,0,12,0,0,50,0,50,0,0,62,0,62,96,0,96,158
02/22/2021,OMN,FL,ASO,ES,Federal Contract Tower,0,0,17,0,17,0,0,183,0,183,0,0,200,0,200,384,0,384,584
02/23/2021,OMN,FL,ASO,ES,Federal Contract Tower,0,0,18,0,18,0,0,181,0,181,0,0,199,0,199,426,0,426,625
02/24/2021,OMN,FL,ASO,ES,Federal Contract Tower,0,0,20,0,20,0,0,217,0,217,0,0,237,0,237,348,0,348,585
02/25/2021,OMN,FL,ASO,ES,Federal Contract Tower,0,0,9,0,9,0,0,167,0,167,0,0,176,0,176,402,0,402,578
02/26/2021,OMN,FL,ASO,ES,Federal Contract Tower,0,0,16,0,16,0,0,124,0,124,0,0,140,0,140,402,0,402,542
02/27/2021,OMN,FL,ASO,ES,Federal Contract Tower,0,0,15,0,15,0,0,165,0,165,0,0,180,0,180,194,0,194,374
02/28/2021,OMN,FL,ASO,ES,Federal Contract Tower,0,0,16,0,16,0,0,109,0,109,0,0,125,0,125,242,0,242,367
03/01/2021,OMN,FL,ASO,ES,Federal Contract Tower,0,0,13,0,13,0,0,123,0,123,0,0,136,0,136,366,0,366,502
03/02/2021,OMN,FL,ASO,ES,Federal Contract Tower,0,0,18,0,18,0,0,3,0,3,0,0,21,0,21,58,0,58,79
03/03/2021,OMN,FL,ASO,ES,Federal Contract Tower,0,0,7,0,7,0,0,42,0,42,0,0,49,0,49,134,0,134,183
03/04/2021,OMN,FL,ASO,ES,Federal Contract Tower,0,0,8,0,8,0,0,195,0,195,0,0,203,0,203,274,0,274,477
03/05/2021,OMN,FL,ASO,ES,Federal Contract Tower,0,0,7,0,7,0,0,120,0,120,0,0,127,0,127,418,0,418,545
03/06/2021,OMN,FL,ASO,ES,Federal Contract Tower,0,0,6,0,6,0,0,68,0,68,0,0,74,0,74,72,0,72,146
03/07/2021,OMN,FL,ASO,ES,Federal Contract Tower,0,0,6,0,6,0,0,6,0,6,0,0,12,0,12,8,0,8,20
03/08/2021,OMN,FL,ASO,ES,Federal Contract Tower,0,0,15,0,15,0,0,77,0,77,0,0,92,0,92,230,0,230,322
03/09/2021,OMN,FL,ASO,ES,Federal Contract Tower,0,2,13,0,15,0,0,175,0,175,0,2,188,0,190,468,0,468,658
03/10/2021,OMN,FL,ASO,ES,Federal Contract Tower,0,0,14,0,14,0,0,171,0,171,0,0,185,0,185,386,0,386,571
03/11/2021,OMN,FL,ASO,ES,Federal Contract Tower,0,0,11,0,11,0,0,187,0,187,0,0,198,0,198,402,0,402,600
03/12/2021,OMN,FL,ASO,ES,Federal Contract Tower,0,0,13,0,13,0,0,183,0,183,0,0,196,0,196,522,0,522,718
03/13/2021,OMN,FL,ASO,ES,Federal Contract Tower,0,0,22,0,22,0,0,152,0,152,0,0,174,0,174,298,0,298,472
03/14/2021,OMN,FL,ASO,ES,Federal Contract Tower,0,0,4,0,4,0,0,104,0,104,0,0,108,0,108,176,0,176,284
03/15/2021,OMN,FL,ASO,ES,Federal Contract Tower,0,0,12,0,12,0,0,176,0,176,0,0,188,0,188,548,0,548,736
03/16/2021,OMN,FL,ASO,ES,Federal Contract Tower,0,0,11,0,11,0,0,205,0,205,0,0,216,0,216,358,0,358,574
03/17/2021,OMN,FL,ASO,ES,Federal Contract Tower,0,0,20,0,20,0,0,170,0,170,0,0,190,0,190,314,0,314,504
03/18/2021,OMN,FL,ASO,ES,Federal Contract Tower,0,0,4,0,4,0,0,72,0,72,0,0,76,0,76,98,0,98,174
03/19/2021,OMN,FL,ASO,ES,Federal Contract Tower,0,0,12,0,12,0,0,184,0,184,0,0,196,0,196,420,0,420,616
03/20/2021,OMN,FL,ASO,ES,Federal Contract Tower,0,0,8,0,8,0,0,0,0,0,0,0,8,0,8,0,0,0,8
03/21/2021,OMN,FL,ASO,ES,Federal Contract Tower,0,0,4,0,4,0,0,0,0,0,0,0,4,0,4,0,0,0,4
03/22/2021,OMN,FL,ASO,ES,Federal Contract Tower,0,0,10,0,10,0,0,1,0,1,0,0,11,0,11,4,0,4,15
03/23/2021,OMN,FL,ASO,ES,Federal Contract Tower,0,0,16,0,16,0,0,160,0,160,0,0,176,0,176,270,0,270,446
03/24/2021,OMN,FL,ASO,ES,Federal Contract Tower,0,0,13,0,13,0,0,224,0,224,0,0,237,0,237,284,0,284,521
03/25/2021,OMN,FL,ASO,ES,Federal Contract Tower,0,0,8,0,8,0,0,110,0,110,0,0,118,0,118,258,0,258,376
03/26/2021,OMN,FL,ASO,ES,Federal Contract Tower,0,0,13,0,13,0,0,117,0,117,0,0,130,0,130,332,0,332,462
03/27/2021,OMN,FL,ASO,ES,Federal Contract Tower,0,0,17,0,17,0,0,149,0,149,0,0,166,0,166,217,0,217,383
03/28/2021,OMN,FL,ASO,ES,Federal Contract Tower,0,0,6,0,6,0,0,42,0,42,0,0,48,0,48,86,0,86,134
03/29/2021,OMN,FL,ASO,ES,Federal Contract Tower,0,0,11,0,11,0,0,126,0,126,0,0,137,0,137,340,0,340,477
03/30/2021,OMN,FL,ASO,ES,Federal Contract Tower,0,0,20,0,20,0,0,153,0,153,0,0,173,0,173,316,0,316,489
03/31/2021,OMN,FL,ASO,ES,Federal Contract Tower,0,0,13,0,13,0,0,128,0,128,0,0,141,0,141,210,0,210,351
04/01/2021,OMN,FL,ASO,ES,Federal Contract Tower,0,0,7,0,7,0,0,90,0,90,0,0,97,0,97,304,0,304,401
04/02/2021,OMN,FL,ASO,ES,Federal Contract Tower,0,0,10,0,10,0,0,53,0,53,0,0,63,0,63,44,0,44,107
04/03/2021,OMN,FL,ASO,ES,Federal Contract Tower,0,0,6,0,6,0,0,76,0,76,0,0,82,0,82,126,0,126,208
04/04/2021,OMN,FL,ASO,ES,Federal Contract Tower,0,0,9,0,9,0,0,67,0,67,0,0,76,0,76,209,0,209,285
04/05/2021,OMN,FL,ASO,ES,Federal Contract Tower,0,0,16,0,16,0,0,145,0,145,0,0,161,0,161,362,0,362,523
04/06/2021,OMN,FL,ASO,ES,Federal Contract Tower,0,0,20,0,20,0,0,143,0,143,0,0,163,0,163,282,0,282,445
04/07/2021,OMN,FL,ASO,ES,Federal Contract Tower,0,0,13,0,13,0,0,161,0,161,0,0,174,0,174,242,0,242,416
04/08/2021,OMN,FL,ASO,ES,Federal Contract Tower,0,0,14,0,14,0,0,207,0,207,0,0,221,0,221,460,0,460,681
04/09/2021,OMN,FL,ASO,ES,Federal Contract Tower,0,0,11,0,11,0,0,159,0,159,0,0,170,0,170,348,0,348,518
04/10/2021,OMN,FL,ASO,ES,Federal Contract Tower,0,0,3,0,3,0,0,41,0,41,0,0,44,0,44,86,0,86,130
04/11/2021,OMN,FL,ASO,ES,Federal Contract Tower,0,0,4,0,4,0,0,2,0,2,0,0,6,0,6,0,0,0,6
04/12/2021,OMN,FL,ASO,ES,Federal Contract Tower,0,0,12,0,12,0,0,113,0,113,0,0,125,0,125,316,0,316,441
04/13/2021,OMN,FL,ASO,ES,Federal Contract Tower,0,0,12,0,12,0,0,188,0,188,0,0,200,0,200,324,0,324,524
04/14/2021,OMN,FL,ASO,ES,Federal Contract Tower,0,0,15,0,15,0,0,188,0,188,0,0,203,0,203,280,0,280,483
04/15/2021,OMN,FL,ASO,ES,Federal Contract Tower,0,0,13,0,13,0,0,144,0,144,0,0,157,0,157,222,0,222,379
04/16/2021,OMN,FL,ASO,ES,Federal Contract Tower,0,0,9,0,9,0,0,108,0,108,0,0,117,0,117,244,0,244,361
04/17/2021,OMN,FL,ASO,ES,Federal Contract Tower,0,0,10,0,10,0,0,0,0,0,0,0,10,0,10,10,0,10,20
04/18/2021,OMN,FL,ASO,ES,Federal Contract Tower,0,0,2,0,2,0,0,33,0,33,0,0,35,0,35,24,0,24,59
04/19/2021,OMN,FL,ASO,ES,Federal Contract Tower,0,0,6,0,6,0,0,22,0,22,0,0,28,0,28,24,0,24,52
04/20/2021,OMN,FL,ASO,ES,Federal Contract Tower,0,0,1,0,1,0,0,26,0,26,0,0,27,0,27,76,0,76,103
04/21/2021,OMN,FL,ASO,ES,Federal Contract Tower,0,1,12,0,13,0,0,176,0,176,0,1,188,0,189,222,0,222,411
04/22/2021,OMN,FL,ASO,ES,Federal Contract Tower,0,0,18,0,18,0,0,132,0,132,0,0,150,0,150,276,0,276,426
04/23/2021,OMN,FL,ASO,ES,Federal Contract Tower,0,0,13,0,13,0,0,143,0,143,0,0,156,0,156,308,0,308,464
04/24/2021,OMN,FL,ASO,ES,Federal Contract Tower,0,0,9,0,9,0,0,76,0,76,0,0,85,0,85,226,0,226,311
04/25/2021,OMN,FL,ASO,ES,Federal Contract Tower,0,0,1,0,1,0,0,15,0,15,0,0,16,0,16,60,0,60,76
04/26/2021,OMN,FL,ASO,ES,Federal Contract Tower,0,0,15,0,15,0,0,128,0,128,0,0,143,0,143,238,0,238,381
04/27/2021,OMN,FL,ASO,ES,Federal Contract Tower,0,0,24,0,24,0,0,103,0,103,0,0,127,0,127,216,0,216,343
04/28/2021,OMN,FL,ASO,ES,Federal Contract Tower,0,0,11,0,11,0,0,156,0,156,0,0,167,0,167,168,0,168,335
04/29/2021,OMN,FL,ASO,ES,Federal Contract Tower,0,0,16,0,16,0,0,193,0,193,0,0,209,0,209,378,0,378,587
04/30/2021,OMN,FL,ASO,ES,Federal Contract Tower,0,0,19,0,19,0,0,149,0,149,0,0,168,0,168,324,0,324,492
05/01/2021,OMN,FL,ASO,ES,Federal Contract Tower,0,0,7,0,7,0,0,109,0,109,0,0,116,0,116,156,0,156,272
05/02/2021,OMN,FL,ASO,ES,Federal Contract Tower,0,0,5,0,5,0,0,43,0,43,0,0,48,0,48,146,0,146,194
05/03/2021,OMN,FL,ASO,ES,Federal Contract Tower,0,0,10,0,10,0,0,118,0,118,0,0,128,0,128,306,0,306,434
05/04/2021,OMN,FL,ASO,ES,Federal Contract Tower,0,0,18,0,18,0,0,142,0,142,0,0,160,0,160,368,0,368,528
05/05/2021,OMN,FL,ASO,ES,Federal Contract Tower,0,0,14,0,14,0,0,132,0,132,0,0,146,0,146,244,0,244,390
05/06/2021,OMN,FL,ASO,ES,Federal Contract Tower,0,0,4,0,4,0,0,54,0,54,0,0,58,0,58,94,0,94,152
05/07/2021,OMN,FL,ASO,ES,Federal Contract Tower,0,0,6,0,6,0,0,153,0,153,0,0,159,0,159,316,0,316,475
05/08/2021,OMN,FL,ASO,ES,Federal Contract Tower,0,0,9,0,9,0,0,116,0,116,0,0,125,0,125,182,0,182,307
05/09/2021,OMN,FL,ASO,ES,Federal Contract Tower,0,0,6,0,6,0,0,83,0,83,0,0,89,0,89,152,0,152,241
05/10/2021,OMN,FL,ASO,ES,Federal Contract Tower,0,0,13,0,13,0,0,104,0,104,0,0,117,0,117,276,0,276,393
05/11/2021,OMN,FL,ASO,ES,Federal Contract Tower,0,0,5,0,5,0,0,91,0,91,0,0,96,0,96,208,0,208,304
05/12/2021,OMN,FL,ASO,ES,Federal Contract Tower,0,0,10,0,10,0,0,131,0,131,0,0,141,0,141,184,0,184,325
05/13/2021,OMN,FL,ASO,ES,Federal Contract Tower,0,3,23,0,26,0,0,10,0,10,0,3,33,0,36,14,0,14,50
05/14/2021,OMN,FL,ASO,ES,Federal Contract Tower,0,0,18,0,18,0,0,90,0,90,0,0,108,0,108,100,0,100,208
05/15/2021,OMN,FL,ASO,ES,Federal Contract Tower,0,0,16,0,16,0,0,58,0,58,0,0,74,0,74,46,0,46,120
05/16/2021,OMN,FL,ASO,ES,Federal Contract Tower,0,0,10,0,10,0,0,74,0,74,0,0,84,0,84,184,0,184,268
05/17/2021,OMN,FL,ASO,ES,Federal Contract Tower,0,0,20,0,20,0,0,116,0,116,0,0,136,0,136,340,0,340,476
05/18/2021,OMN,FL,ASO,ES,Federal Contract Tower,0,0,17,0,17,0,0,102,0,102,0,0,119,0,119,172,0,172,291
05/19/2021,OMN,FL,ASO,ES,Federal Contract Tower,0,0,22,0,22,0,0,76,0,76,0,0,98,0,98,84,0,84,182
05/20/2021,OMN,FL,ASO,ES,Federal Contract Tower,0,0,12,0,12,0,0,63,0,63,0,0,75,0,75,108,0,108,183
05/21/2021,OMN,FL,ASO,ES,Federal Contract Tower,0,0,17,0,17,0,0,94,0,94,0,0,111,0,111,168,0,168,279
05/22/2021,OMN,FL,ASO,ES,Federal Contract Tower,0,0,7,0,7,0,0,74,0,74,0,0,81,0,81,100,0,100,181
05/23/2021,OMN,FL,ASO,ES,Federal Contract Tower,0,0,9,0,9,0,0,60,0,60,0,0,69,0,69,90,0,90,159
05/24/2021,OMN,FL,ASO,ES,Federal Contract Tower,0,0,13,0,13,0,0,135,0,135,0,0,148,0,148,256,0,256,404
05/25/2021,OMN,FL,ASO,ES,Federal Contract Tower,0,0,10,0,10,0,0,131,0,131,0,0,141,0,141,326,0,326,467
05/26/2021,OMN,FL,ASO,ES,Federal Contract Tower,0,0,14,0,14,0,0,177,0,177,0,0,191,0,191,338,0,338,529
05/27/2021,OMN,FL,ASO,ES,Federal Contract Tower,0,0,12,0,12,0,0,158,0,158,0,0,170,0,170,252,0,252,422
05/28/2021,OMN,FL,ASO,ES,Federal Contract Tower,0,0,16,0,16,0,0,140,0,140,0,0,156,0,156,314,0,314,470
05/29/2021,OMN,FL,ASO,ES,Federal Contract Tower,0,0,8,0,8,0,0,104,0,104,0,0,112,0,112,218,0,218,330
05/30/2021,OMN,FL,ASO,ES,Federal Contract Tower,0,0,5,0,5,0,0,67,0,67,0,0,72,0,72,136,0,136,208
05/31/2021,OMN,FL,ASO,ES,Federal Contract Tower,0,0,23,0,23,0,0,95,0,95,0,0,118,0,118,170,0,170,288
06/01/2021,OMN,FL,ASO,ES,Federal Contract Tower,0,0,16,0,16,0,0,123,0,123,0,0,139,0,139,282,0,282,421
06/02/2021,OMN,FL,ASO,ES,Federal Contract Tower,0,0,10,0,10,0,0,89,0,89,0,0,99,0,99,78,0,78,177
06/03/2021,OMN,FL,ASO,ES,Federal Contract Tower,0,0,14,0,14,0,0,142,0,142,0,0,156,0,156,288,0,288,444
06/04/2021,OMN,FL,ASO,ES,Federal Contract Tower,0,0,10,0,10,0,0,62,0,62,0,0,72,0,72,186,0,186,258
06/05/2021,OMN,FL,ASO,ES,Federal Contract Tower,0,0,15,0,15,0,0,88,0,88,0,0,103,0,103,152,0,152,255
06/06/2021,OMN,FL,ASO,ES,Federal Contract Tower,0,0,10,0,10,0,0,119,0,119,0,0,129,0,129,266,0,266,395
06/07/2021,OMN,FL,ASO,ES,Federal Contract Tower,0,0,19,0,19,0,0,144,0,144,0,0,163,0,163,414,0,414,577
06/08/2021,OMN,FL,ASO,ES,Federal Contract Tower,0,0,9,0,9,0,0,122,0,122,0,0,131,0,131,286,0,286,417
06/09/2021,OMN,FL,ASO,ES,Federal Contract Tower,0,0,7,0,7,0,0,155,0,155,0,0,162,0,162,306,0,306,468
06/10/2021,OMN,FL,ASO,ES,Federal Contract Tower,0,0,16,0,16,0,0,162,0,162,0,0,178,0,178,346,0,346,524
06/11/2021,OMN,FL,ASO,ES,Federal Contract Tower,0,0,9,0,9,0,0,138,0,138,0,0,147,0,147,302,0,302,449
06/12/2021,OMN,FL,ASO,ES,Federal Contract Tower,0,0,6,0,6,0,0,122,0,122,0,0,128,0,128,136,0,136,264
06/13/2021,OMN,FL,ASO,ES,Federal Contract Tower,0,0,3,0,3,0,0,40,0,40,0,0,43,0,43,54,0,54,97
06/14/2021,OMN,FL,ASO,ES,Federal Contract Tower,0,0,6,0,6,0,0,65,0,65,0,0,71,0,71,106,0,106,177
06/15/2021,OMN,FL,ASO,ES,Federal Contract Tower,0,0,7,0,7,0,0,79,0,79,0,0,86,0,86,142,0,142,228
06/16/2021,OMN,FL,ASO,ES,Federal Contract Tower,0,0,16,0,16,0,0,197,0,197,0,0,213,0,213,138,0,138,351
06/17/2021,OMN,FL,ASO,ES,Federal Contract Tower,0,0,15,0,15,0,0,165,0,165,0,0,180,0,180,288,0,288,468
06/18/2021,OMN,FL,ASO,ES,Federal Contract Tower,0,0,11,0,11,0,0,66,0,66,0,0,77,0,77,178,0,178,255
06/19/2021,OMN,FL,ASO,ES,Federal Contract Tower,0,0,14,0,14,0,0,87,0,87,0,0,101,0,101,120,0,120,221
06/20/2021,OMN,FL,ASO,ES,Federal Contract Tower,0,0,6,0,6,0,0,11,0,11,0,0,17,0,17,34,0,34,51
06/21/2021,OMN,FL,ASO,ES,Federal Contract Tower,0,0,11,0,11,0,0,78,0,78,0,0,89,0,89,154,0,154,243
06/22/2021,OMN,FL,ASO,ES,Federal Contract Tower,0,0,3,0,3,0,0,70,0,70,0,0,73,0,73,200,0,200,273
06/23/2021,OMN,FL,ASO,ES,Federal Contract Tower,0,0,13,0,13,0,0,131,0,131,0,0,144,0,144,152,0,152,296
06/24/2021,OMN,FL,ASO,ES,Federal Contract Tower,0,0,10,0,10,0,0,41,0,41,0,0,51,0,51,72,0,72,123
06/25/2021,OMN,FL,ASO,ES,Federal Contract Tower,0,0,9,0,9,0,0,79,0,79,0,0,88,0,88,62,0,62,150
06/26/2021,OMN,FL,ASO,ES,Federal Contract Tower,0,0,11,0,11,0,0,74,0,74,0,0,85,0,85,98,0,98,183
06/27/2021,OMN,FL,ASO,ES,Federal Contract Tower,0,0,11,0,11,0,0,50,0,50,0,0,61,0,61,50,0,50,111
06/28/2021,OMN,FL,ASO,ES,Federal Contract Tower,0,0,20,0,20,0,0,107,0,107,0,0,127,0,127,326,0,326,453
06/29/2021,OMN,FL,ASO,ES,Federal Contract Tower,0,0,19,0,19,0,0,104,0,104,0,0,123,0,123,163,0,163,286
06/30/2021,OMN,FL,ASO,ES,Federal Contract Tower,0,0,19,0,19,0,0,111,0,111,0,0,130,0,130,118,0,118,248
07/01/2021,OMN,FL,ASO,ES,Federal Contract Tower,0,0,17,0,17,0,0,71,0,71,0,0,88,0,88,74,0,74,162
07/02/2021,OMN,FL,ASO,ES,Federal Contract Tower,0,0,22,0,22,0,0,74,0,74,0,0,96,0,96,126,0,126,222
07/03/2021,OMN,FL,ASO,ES,Federal Contract Tower,0,0,22,0,22,0,0,9,0,9,0,0,31,0,31,22,0,22,53
07/04/2021,OMN,FL,ASO,ES,Federal Contract Tower,0,0,1,0,1,0,0,3,0,3,0,0,4,0,4,0,0,0,4
07/05/2021,OMN,FL,ASO,ES,Federal Contract Tower,0,0,17,0,17,0,0,95,0,95,0,0,112,0,112,124,0,124,236
07/06/2021,OMN,FL,ASO,ES,Federal Contract Tower,0,0,17,0,17,0,0,58,0,58,0,0,75,0,75,80,0,80,155
07/07/2021,OMN,FL,ASO,ES,Federal Contract Tower,0,0,1,0,1,0,0,0,0,0,0,0,1,0,1,0,0,0,1
07/08/2021,OMN,FL,ASO,ES,Federal Contract Tower,0,0,7,0,7,0,0,25,0,25,0,0,32,0,32,8,0,8,40
07/09/2021,OMN,FL,ASO,ES,Federal Contract Tower,0,0,16,0,16,0,0,111,0,111,0,0,127,0,127,192,0,192,319
07/10/2021,OMN,FL,ASO,ES,Federal Contract Tower,0,0,12,0,12,0,0,71,0,71,0,0,83,0,83,108,0,108,191
07/11/2021,OMN,FL,ASO,ES,Federal Contract Tower,0,0,6,0,6,0,0,55,0,55,0,0,61,0,61,80,0,80,141
07/12/2021,OMN,FL,ASO,ES,Federal Contract Tower,0,0,16,0,16,0,0,76,0,76,0,0,92,0,92,98,0,98,190
07/13/2021,OMN,FL,ASO,ES,Federal Contract Tower,0,0,15,0,15,0,0,161,0,161,0,0,176,0,176,104,0,104,280
07/14/2021,OMN,FL,ASO,ES,Federal Contract Tower,0,0,19,0,19,0,0,142,0,142,0,0,161,0,161,146,0,146,307
07/15/2021,OMN,FL,ASO,ES,Federal Contract Tower,0,0,32,0,32,0,0,132,0,132,0,0,164,0,164,192,0,192,356
07/16/2021,OMN,FL,ASO,ES,Federal Contract Tower,0,0,20,0,20,0,0,134,0,134,0,0,154,0,154,274,0,274,428
07/17/2021,OMN,FL,ASO,ES,Federal Contract Tower,0,0,11,0,11,0,0,125,0,125,0,0,136,0,136,196,0,196,332
07/18/2021,OMN,FL,ASO,ES,Federal Contract Tower,0,0,12,0,12,0,0,57,0,57,0,0,69,0,69,82,0,82,151
07/19/2021,OMN,FL,ASO,ES,Federal Contract Tower,0,0,6,0,6,0,0,119,0,119,0,0,125,0,125,178,0,178,303
07/20/2021,OMN,FL,ASO,ES,Federal Contract Tower,0,0,6,0,6,0,0,117,0,117,0,0,123,0,123,166,0,166,289
07/21/2021,OMN,FL,ASO,ES,Federal Contract Tower,0,0,22,0,22,0,0,142,0,142,0,0,164,0,164,262,0,262,426
07/22/2021,OMN,FL,ASO,ES,Federal Contract Tower,0,0,14,0,14,0,0,117,0,117,0,0,131,0,131,288,0,288,419
07/23/2021,OMN,FL,ASO,ES,Federal Contract Tower,0,0,17,0,17,0,0,54,0,54,0,0,71,0,71,78,0,78,149
07/24/2021,OMN,FL,ASO,ES,Federal Contract Tower,0,0,21,0,21,0,0,123,0,123,0,0,144,0,144,202,0,202,346
07/25/2021,OMN,FL,ASO,ES,Federal Contract Tower,0,0,10,0,10,0,0,40,0,40,0,0,50,0,50,96,0,96,146
07/26/2021,OMN,FL,ASO,ES,Federal Contract Tower,0,0,15,0,15,0,0,112,0,112,0,0,127,0,127,176,0,176,303
07/27/2021,OMN,FL,ASO,ES,Federal Contract Tower,0,0,5,0,5,0,0,114,0,114,0,0,119,0,119,200,0,200,319
07/28/2021,OMN,FL,ASO,ES,Federal Contract Tower,0,0,14,0,14,0,0,104,0,104,0,0,118,0,118,110,0,110,228
07/29/2021,OMN,FL,ASO,ES,Federal Contract Tower,0,0,7,0,7,0,0,105,0,105,0,0,112,0,112,106,0,106,218
07/30/2021,OMN,FL,ASO,ES,Federal Contract Tower,0,0,14,0,14,0,0,72,0,72,0,0,86,0,86,74,0,74,160
07/31/2021,OMN,FL,ASO,ES,Federal Contract Tower,0,0,14,0,14,0,0,91,0,91,0,0,105,0,105,134,0,134,239
08/01/2021,OMN,FL,ASO,ES,Federal Contract Tower,0,0,5,0,5,0,0,69,0,69,0,0,74,0,74,146,0,146,220
08/02/2021,OMN,FL,ASO,ES,Federal Contract Tower,0,0,10,0,10,0,0,46,0,46,0,0,56,0,56,130,0,130,186
08/03/2021,OMN,FL,ASO,ES,Federal Contract Tower,0,0,8,0,8,0,0,56,0,56,0,0,64,0,64,56,0,56,120
08/04/2021,OMN,FL,ASO,ES,Federal Contract Tower,0,0,15,0,15,0,0,10,0,10,0,0,25,0,25,10,0,10,35
08/05/2021,OMN,FL,ASO,ES,Federal Contract Tower,0,0,7,0,7,0,0,95,0,95,0,0,102,0,102,130,0,130,232
08/06/2021,OMN,FL,ASO,ES,Federal Contract Tower,0,0,14,0,14,0,0,139,0,139,0,0,153,0,153,224,0,224,377
08/07/2021,OMN,FL,ASO,ES,Federal Contract Tower,0,0,16,0,16,0,0,102,0,102,0,0,118,0,118,80,0,80,198
08/08/2021,OMN,FL,ASO,ES,Federal Contract Tower,0,0,12,0,12,0,0,47,0,47,0,0,59,0,59,58,0,58,117
08/09/2021,OMN,FL,ASO,ES,Federal Contract Tower,0,0,8,0,8,0,0,91,0,91,0,0,99,0,99,222,0,222,321
08/10/2021,OMN,FL,ASO,ES,Federal Contract Tower,0,0,9,0,9,0,0,89,0,89,0,0,98,0,98,192,0,192,290
08/11/2021,OMN,FL,ASO,ES,Federal Contract Tower,0,0,16,0,16,0,0,145,0,145,0,0,161,0,161,76,0,76,237
08/12/2021,OMN,FL,ASO,ES,Federal Contract Tower,0,0,8,0,8,0,0,138,0,138,0,0,146,0,146,166,0,166,312
08/13/2021,OMN,FL,ASO,ES,Federal Contract Tower,0,0,11,0,11,0,0,65,0,65,0,0,76,0,76,102,0,102,178
08/14/2021,OMN,FL,ASO,ES,Federal Contract Tower,0,0,3,0,3,0,0,39,0,39,0,0,42,0,42,40,0,40,82
08/15/2021,OMN,FL,ASO,ES,Federal Contract Tower,0,0,6,0,6,0,0,25,0,25,0,0,31,0,31,54,0,54,85
08/16/2021,OMN,FL,ASO,ES,Federal Contract Tower,0,0,14,0,14,0,0,59,0,59,0,0,73,0,73,98,0,98,171
08/17/2021,OMN,FL,ASO,ES,Federal Contract Tower,0,0,17,0,17,0,0,93,0,93,0,0,110,0,110,196,0,196,306
08/18/2021,OMN,FL,ASO,ES,Federal Contract Tower,0,0,12,0,12,0,0,98,0,98,0,0,110,0,110,132,0,132,242
08/19/2021,OMN,FL,ASO,ES,Federal Contract Tower,0,0,16,0,16,0,0,76,0,76,0,0,92,0,92,116,0,116,208
08/20/2021,OMN,FL,ASO,ES,Federal Contract Tower,0,0,16,0,16,0,0,126,0,126,0,0,142,0,142,216,0,216,358
08/21/2021,OMN,FL,ASO,ES,Federal Contract Tower,0,0,5,0,5,0,0,122,0,122,0,0,127,0,127,64,0,64,191
08/22/2021,OMN,FL,ASO,ES,Federal Contract Tower,0,0,16,0,16,0,0,50,0,50,0,0,66,0,66,34,0,34,100
08/23/2021,OMN,FL,ASO,ES,Federal Contract Tower,0,0,13,0,13,0,0,110,0,110,0,0,123,0,123,256,0,256,379
08/24/2021,OMN,FL,ASO,ES,Federal Contract Tower,0,0,11,0,11,0,0,73,0,73,0,0,84,0,84,170,0,170,254
08/25/2021,OMN,FL,ASO,ES,Federal Contract Tower,0,0,16,0,16,0,0,150,0,150,0,0,166,0,166,150,0,150,316
08/26/2021,OMN,FL,ASO,ES,Federal Contract Tower,0,0,11,0,11,0,0,53,0,53,0,0,64,0,64,54,0,54,118
08/27/2021,OMN,FL,ASO,ES,Federal Contract Tower,0,0,3,0,3,0,0,11,0,11,0,0,14,0,14,48,0,48,62
08/28/2021,OMN,FL,ASO,ES,Federal Contract Tower,0,0,13,0,13,0,0,46,0,46,0,0,59,0,59,56,0,56,115
08/29/2021,OMN,FL,ASO,ES,Federal Contract Tower,0,0,3,0,3,0,0,26,0,26,0,0,29,0,29,42,0,42,71
08/30/2021,OMN,FL,ASO,ES,Federal Contract Tower,0,0,13,0,13,0,0,91,0,91,0,0,104,0,104,168,0,168,272
08/31/2021,OMN,FL,ASO,ES,Federal Contract Tower,0,0,10,0,10,0,0,76,0,76,0,0,86,0,86,138,0,138,224
09/01/2021,OMN,FL,ASO,ES,Federal Contract Tower,0,0,4,0,4,0,0,29,0,29,0,0,33,0,33,54,0,54,87
09/02/2021,OMN,FL,ASO,ES,Federal Contract Tower,0,0,12,0,12,0,0,86,0,86,0,0,98,0,98,104,0,104,202
09/03/2021,OMN,FL,ASO,ES,Federal Contract Tower,0,0,10,0,10,0,0,108,0,108,0,0,118,0,118,126,0,126,244
09/04/2021,OMN,FL,ASO,ES,Federal Contract Tower,0,0,3,0,3,0,0,86,0,86,0,0,89,0,89,72,0,72,161
09/05/2021,OMN,FL,ASO,ES,Federal Contract Tower,0,0,4,0,4,0,0,26,0,26,0,0,30,0,30,24,0,24,54
09/06/2021,OMN,FL,ASO,ES,Federal Contract Tower,0,0,15,0,15,0,0,123,0,123,0,0,138,0,138,186,0,186,324
09/07/2021,OMN,FL,ASO,ES,Federal Contract Tower,0,0,8,0,8,0,0,115,0,115,0,0,123,0,123,158,0,158,281
09/08/2021,OMN,FL,ASO,ES,Federal Contract Tower,0,0,15,0,15,0,0,177,0,177,0,0,192,0,192,148,0,148,340
09/09/2021,OMN,FL,ASO,ES,Federal Contract Tower,0,0,14,0,14,0,0,34,0,34,0,0,48,0,48,12,0,12,60
09/10/2021,OMN,FL,ASO,ES,Federal Contract Tower,0,0,14,0,14,0,0,56,0,56,0,0,70,0,70,98,0,98,168
09/11/2021,OMN,FL,ASO,ES,Federal Contract Tower,0,0,7,0,7,0,0,33,0,33,0,0,40,0,40,92,0,92,132
09/12/2021,OMN,FL,ASO,ES,Federal Contract Tower,0,0,7,0,7,0,0,42,0,42,0,0,49,0,49,48,0,48,97
09/13/2021,OMN,FL,ASO,ES,Federal Contract Tower,0,0,8,0,8,0,0,100,0,100,0,0,108,0,108,220,0,220,328
09/14/2021,OMN,FL,ASO,ES,Federal Contract Tower,0,0,10,0,10,0,0,122,0,122,0,0,132,0,132,202,0,202,334
09/15/2021,OMN,FL,ASO,ES,Federal Contract Tower,0,0,10,0,10,0,0,98,0,98,0,0,108,0,108,160,0,160,268
09/16/2021,OMN,FL,ASO,ES,Federal Contract Tower,0,0,11,0,11,0,0,134,0,134,0,0,145,0,145,176,0,176,321
09/17/2021,OMN,FL,ASO,ES,Federal Contract Tower,0,0,12,0,12,0,0,91,0,91,0,0,103,0,103,82,0,82,185
09/18/2021,OMN,FL,ASO,ES,Federal Contract Tower,0,0,10,0,10,0,0,55,0,55,0,0,65,0,65,36,0,36,101
09/19/2021,OMN,FL,ASO,ES,Federal Contract Tower,0,0,1,0,1,0,0,29,0,29,0,0,30,0,30,54,0,54,84
09/20/2021,OMN,FL,ASO,ES,Federal Contract Tower,0,0,7,0,7,0,0,56,0,56,0,0,63,0,63,108,0,108,171
09/21/2021,OMN,FL,ASO,ES,Federal Contract Tower,0,0,14,0,14,0,0,135,0,135,0,0,149,0,149,214,0,214,363
09/22/2021,OMN,FL,ASO,ES,Federal Contract Tower,0,0,19,0,19,0,0,118,0,118,0,0,137,0,137,184,0,184,321
09/23/2021,OMN,FL,ASO,ES,Federal Contract Tower,0,0,8,0,8,0,0,185,0,185,0,0,193,0,193,146,0,146,339
09/24/2021,OMN,FL,ASO,ES,Federal Contract Tower,0,0,13,0,13,0,0,133,0,133,0,0,146,0,146,240,0,240,386
09/25/2021,OMN,FL,ASO,ES,Federal Contract Tower,0,0,13,0,13,0,0,119,0,119,0,0,132,0,132,132,0,132,264
09/26/2021,OMN,FL,ASO,ES,Federal Contract Tower,0,0,4,0,4,0,0,28,0,28,0,0,32,0,32,16,0,16,48
09/27/2021,OMN,FL,ASO,ES,Federal Contract Tower,0,0,9,0,9,0,0,107,0,107,0,0,116,0,116,301,0,301,417
09/28/2021,OMN,FL,ASO,ES,Federal Contract Tower,0,0,9,0,9,0,0,116,0,116,0,0,125,0,125,242,0,242,367
09/29/2021,OMN,FL,ASO,ES,Federal Contract Tower,0,0,12,0,12,0,0,140,0,140,0,0,152,0,152,348,0,348,500
09/30/2021,OMN,FL,ASO,ES,Federal Contract Tower,0,0,5,0,5,0,0,162,0,162,0,0,167,0,167,294,0,294,461
10/01/2021,OMN,FL,ASO,ES,Federal Contract Tower,0,0,8,0,8,0,0,53,0,53,0,0,61,0,61,148,0,148,209
10/02/2021,OMN,FL,ASO,ES,Federal Contract Tower,0,0,9,0,9,0,0,98,0,98,0,0,107,0,107,158,0,158,265
10/03/2021,OMN,FL,ASO,ES,Federal Contract Tower,0,0,9,0,9,0,0,30,0,30,0,0,39,0,39,32,0,32,71
10/04/2021,OMN,FL,ASO,ES,Federal Contract Tower,0,0,16,0,16,0,0,120,0,120,0,0,136,0,136,260,0,260,396
10/05/2021,OMN,FL,ASO,ES,Federal Contract Tower,0,0,9,0,9,0,0,128,0,128,0,0,137,0,137,272,0,272,409
10/06/2021,OMN,FL,ASO,ES,Federal Contract Tower,0,0,15,0,15,0,0,136,0,136,0,0,151,0,151,250,0,250,401
10/07/2021,OMN,FL,ASO,ES,Federal Contract Tower,0,0,21,0,21,0,0,103,0,103,0,0,124,0,124,252,0,252,376
10/08/2021,OMN,FL,ASO,ES,Federal Contract Tower,0,0,5,0,5,0,0,127,0,127,0,0,132,0,132,136,0,136,268
10/09/2021,OMN,FL,ASO,ES,Federal Contract Tower,0,0,25,0,25,0,0,33,0,33,0,0,58,0,58,122,0,122,180
10/10/2021,OMN,FL,ASO,ES,Federal Contract Tower,0,0,5,0,5,0,0,18,0,18,0,0,23,0,23,10,0,10,33
10/11/2021,OMN,FL,ASO,ES,Federal Contract Tower,0,0,10,0,10,0,0,101,0,101,0,0,111,0,111,310,0,310,421
10/12/2021,OMN,FL,ASO,ES,Federal Contract Tower,0,0,18,0,18,0,0,140,0,140,0,0,158,0,158,292,0,292,450
10/13/2021,OMN,FL,ASO,ES,Federal Contract Tower,0,0,15,0,15,0,0,114,0,114,0,0,129,0,129,224,0,224,353
10/14/2021,OMN,FL,ASO,ES,Federal Contract Tower,0,0,12,0,12,0,0,87,0,87,0,0,99,0,99,210,0,210,309
10/15/2021,OMN,FL,ASO,ES,Federal Contract Tower,0,0,19,0,19,0,0,144,0,144,0,0,163,0,163,236,0,236,399
10/16/2021,OMN,FL,ASO,ES,Federal Contract Tower,0,0,14,0,14,0,0,130,0,130,0,0,144,0,144,208,0,208,352
10/17/2021,OMN,FL,ASO,ES,Federal Contract Tower,0,0,6,0,6,0,0,35,0,35,0,0,41,0,41,128,0,128,169
10/18/2021,OMN,FL,ASO,ES,Federal Contract Tower,0,0,12,0,12,0,0,117,0,117,0,0,129,0,129,268,0,268,397
10/19/2021,OMN,FL,ASO,ES,Federal Contract Tower,0,0,5,0,5,0,0,121,0,121,0,0,126,0,126,288,0,288,414
10/20/2021,OMN,FL,ASO,ES,Federal Contract Tower,0,0,11,0,11,0,0,168,0,168,0,0,179,0,179,256,0,256,435
10/21/2021,OMN,FL,ASO,ES,Federal Contract Tower,0,0,10,0,10,0,0,112,0,112,0,0,122,0,122,328,0,328,450
10/22/2021,OMN,FL,ASO,ES,Federal Contract Tower,0,0,21,0,21,0,0,112,0,112,0,0,133,0,133,434,0,434,567
10/23/2021,OMN,FL,ASO,ES,Federal Contract Tower,0,0,8,0,8,0,0,123,0,123,0,0,131,0,131,212,0,212,343
10/24/2021,OMN,FL,ASO,ES,Federal Contract Tower,0,0,6,0,6,0,0,31,0,31,0,0,37,0,37,110,0,110,147
10/25/2021,OMN,FL,ASO,ES,Federal Contract Tower,0,0,10,0,10,0,0,71,0,71,0,0,81,0,81,98,0,98,179
10/26/2021,OMN,FL,ASO,ES,Federal Contract Tower,0,0,8,0,8,0,0,80,0,80,0,0,88,0,88,122,0,122,210
10/27/2021,OMN,FL,ASO,ES,Federal Contract Tower,0,0,10,0,10,0,0,198,0,198,0,0,208,0,208,266,0,266,474
10/28/2021,OMN,FL,ASO,ES,Federal Contract Tower,0,0,3,0,3,0,0,45,0,45,0,0,48,0,48,90,0,90,138
10/29/2021,OMN,FL,ASO,ES,Federal Contract Tower,0,0,11,0,11,0,0,99,0,99,0,0,110,0,110,110,0,110,220
10/30/2021,OMN,FL,ASO,ES,Federal Contract Tower,0,0,10,0,10,0,0,143,0,143,0,0,153,0,153,124,0,124,277
10/31/2021,OMN,FL,ASO,ES,Federal Contract Tower,0,0,5,0,5,0,0,86,0,86,0,0,91,0,91,88,0,88,179
11/01/2021,OMN,FL,ASO,ES,Federal Contract Tower,0,0,6,0,6,0,0,130,0,130,0,0,136,0,136,256,0,256,392
11/02/2021,OMN,FL,ASO,ES,Federal Contract Tower,0,0,16,0,16,0,0,152,0,152,0,0,168,0,168,310,0,310,478
11/03/2021,OMN,FL,ASO,ES,Federal Contract Tower,0,0,13,0,13,0,0,273,0,273,0,0,286,0,286,260,0,260,546
11/04/2021,OMN,FL,ASO,ES,Federal Contract Tower,0,0,14,0,14,0,0,154,0,154,0,0,168,0,168,305,0,305,473
11/05/2021,OMN,FL,ASO,ES,Federal Contract Tower,0,0,0,0,0,0,0,0,0,0,0,0,0,0,0,0,0,0,0
11/06/2021,OMN,FL,ASO,ES,Federal Contract Tower,0,0,10,0,10,0,0,5,0,5,0,0,15,0,15,2,0,2,17
11/07/2021,OMN,FL,ASO,ES,Federal Contract Tower,0,0,4,0,4,0,0,11,0,11,0,0,15,0,15,40,0,40,55
11/08/2021,OMN,FL,ASO,ES,Federal Contract Tower,0,0,9,0,9,0,0,120,0,120,0,0,129,0,129,200,0,200,329
11/09/2021,OMN,FL,ASO,ES,Federal Contract Tower,0,0,14,0,14,0,0,187,0,187,0,0,201,0,201,344,0,344,545
11/10/2021,OMN,FL,ASO,ES,Federal Contract Tower,0,0,12,0,12,0,0,185,0,185,0,0,197,0,197,336,0,336,533
11/11/2021,OMN,FL,ASO,ES,Federal Contract Tower,0,0,21,0,21,0,0,168,0,168,0,0,189,0,189,334,0,334,523
11/12/2021,OMN,FL,ASO,ES,Federal Contract Tower,0,0,12,0,12,0,0,23,0,23,0,0,35,0,35,36,0,36,71
11/13/2021,OMN,FL,ASO,ES,Federal Contract Tower,0,0,11,0,11,0,0,44,0,44,0,0,55,0,55,62,0,62,117
11/14/2021,OMN,FL,ASO,ES,Federal Contract Tower,0,0,5,0,5,0,0,108,0,108,0,0,113,0,113,172,0,172,285
11/15/2021,OMN,FL,ASO,ES,Federal Contract Tower,0,0,8,0,8,0,0,149,0,149,0,0,157,0,157,346,0,346,503
11/16/2021,OMN,FL,ASO,ES,Federal Contract Tower,0,0,14,0,14,0,0,212,0,212,0,0,226,0,226,330,0,330,556
11/17/2021,OMN,FL,ASO,ES,Federal Contract Tower,0,0,22,0,22,0,0,242,0,242,0,0,264,0,264,400,0,400,664
11/18/2021,OMN,FL,ASO,ES,Federal Contract Tower,0,0,9,0,9,0,0,169,0,169,0,0,178,0,178,256,0,256,434
11/19/2021,OMN,FL,ASO,ES,Federal Contract Tower,0,0,6,0,6,0,0,39,0,39,0,0,45,0,45,106,0,106,151
11/20/2021,OMN,FL,ASO,ES,Federal Contract Tower,0,0,7,0,7,0,0,39,0,39,0,0,46,0,46,70,0,70,116
11/21/2021,OMN,FL,ASO,ES,Federal Contract Tower,0,0,12,0,12,0,0,42,0,42,0,0,54,0,54,70,0,70,124
11/22/2021,OMN,FL,ASO,ES,Federal Contract Tower,0,0,14,0,14,0,0,42,0,42,0,0,56,0,56,146,0,146,202
11/23/2021,OMN,FL,ASO,ES,Federal Contract Tower,0,0,13,0,13,0,0,95,0,95,0,0,108,0,108,70,0,70,178
11/24/2021,OMN,FL,ASO,ES,Federal Contract Tower,0,0,16,0,16,0,0,139,0,139,0,0,155,0,155,152,0,152,307
11/25/2021,OMN,FL,ASO,ES,Federal Contract Tower,0,0,3,0,3,0,0,17,0,17,0,0,20,0,20,0,0,0,20
11/26/2021,OMN,FL,ASO,ES,Federal Contract Tower,0,0,4,0,4,0,0,93,0,93,0,0,97,0,97,88,0,88,185
11/27/2021,OMN,FL,ASO,ES,Federal Contract Tower,0,0,2,0,2,0,0,100,0,100,0,0,102,0,102,182,0,182,284
11/28/2021,OMN,FL,ASO,ES,Federal Contract Tower,0,0,12,0,12,0,0,60,0,60,0,0,72,0,72,50,0,50,122
11/29/2021,OMN,FL,ASO,ES,Federal Contract Tower,0,0,16,0,16,0,0,124,0,124,0,0,140,0,140,340,0,340,480
11/30/2021,OMN,FL,ASO,ES,Federal Contract Tower,0,0,12,0,12,0,0,197,0,197,0,0,209,0,209,330,0,330,539
12/01/2021,OMN,FL,ASO,ES,Federal Contract Tower,0,0,8,0,8,0,0,201,0,201,0,0,209,0,209,280,0,280,489
12/02/2021,OMN,FL,ASO,ES,Federal Contract Tower,0,0,7,0,7,0,0,188,0,188,0,0,195,0,195,198,0,198,393
12/03/2021,OMN,FL,ASO,ES,Federal Contract Tower,0,0,7,0,7,0,0,152,0,152,0,0,159,0,159,336,0,336,495
12/04/2021,OMN,FL,ASO,ES,Federal Contract Tower,0,0,12,0,12,0,0,87,0,87,0,0,99,0,99,136,0,136,235
12/05/2021,OMN,FL,ASO,ES,Federal Contract Tower,0,0,8,0,8,0,0,45,0,45,0,0,53,0,53,64,0,64,117
12/06/2021,OMN,FL,ASO,ES,Federal Contract Tower,0,0,6,0,6,0,0,74,0,74,0,0,80,0,80,222,0,222,302
12/07/2021,OMN,FL,ASO,ES,Federal Contract Tower,0,0,9,0,9,0,0,13,0,13,0,0,22,0,22,46,0,46,68
12/08/2021,OMN,FL,ASO,ES,Federal Contract Tower,0,0,10,0,10,0,0,114,0,114,0,0,124,0,124,152,0,152,276
12/09/2021,OMN,FL,ASO,ES,Federal Contract Tower,0,0,14,0,14,0,0,133,0,133,0,0,147,0,147,392,0,392,539
12/10/2021,OMN,FL,ASO,ES,Federal Contract Tower,0,0,15,0,15,0,0,87,0,87,0,0,102,0,102,238,0,238,340
12/11/2021,OMN,FL,ASO,ES,Federal Contract Tower,0,0,4,0,4,0,0,74,0,74,0,0,78,0,78,76,0,76,154
12/12/2021,OMN,FL,ASO,ES,Federal Contract Tower,0,0,7,0,7,0,0,6,0,6,0,0,13,0,13,6,0,6,19
12/13/2021,OMN,FL,ASO,ES,Federal Contract Tower,0,0,13,0,13,0,0,116,0,116,0,0,129,0,129,264,0,264,393
12/14/2021,OMN,FL,ASO,ES,Federal Contract Tower,0,0,10,0,10,0,0,8,0,8,0,0,18,0,18,18,0,18,36
12/15/2021,OMN,FL,ASO,ES,Federal Contract Tower,0,0,17,0,17,0,0,71,0,71,0,0,88,0,88,112,0,112,200
12/16/2021,OMN,FL,ASO,ES,Federal Contract Tower,0,0,10,0,10,0,0,152,0,152,0,0,162,0,162,268,0,268,430
12/17/2021,OMN,FL,ASO,ES,Federal Contract Tower,0,0,11,0,11,0,0,88,0,88,0,0,99,0,99,292,0,292,391
12/18/2021,OMN,FL,ASO,ES,Federal Contract Tower,0,0,12,0,12,0,0,88,0,88,0,0,100,0,100,288,0,288,388
12/19/2021,OMN,FL,ASO,ES,Federal Contract Tower,0,0,5,0,5,0,0,17,0,17,0,0,22,0,22,14,0,14,36
12/20/2021,OMN,FL,ASO,ES,Federal Contract Tower,0,0,10,0,10,0,0,9,0,9,0,0,19,0,19,22,0,22,41
12/21/2021,OMN,FL,ASO,ES,Federal Contract Tower,0,0,0,0,0,0,0,0,0,0,0,0,0,0,0,0,0,0,0
12/22/2021,OMN,FL,ASO,ES,Federal Contract Tower,0,2,12,0,14,0,0,78,0,78,0,2,90,0,92,108,0,108,200
12/23/2021,OMN,FL,ASO,ES,Federal Contract Tower,0,0,9,0,9,0,0,102,0,102,0,0,111,0,111,230,0,230,341
12/24/2021,OMN,FL,ASO,ES,Federal Contract Tower,0,0,2,0,2,0,0,43,0,43,0,0,45,0,45,48,0,48,93
12/25/2021,OMN,FL,ASO,ES,Federal Contract Tower,0,0,0,0,0,0,0,9,0,9,0,0,9,0,9,4,0,4,13
12/26/2021,OMN,FL,ASO,ES,Federal Contract Tower,0,0,2,0,2,0,0,33,0,33,0,0,35,0,35,4,0,4,39
12/27/2021,OMN,FL,ASO,ES,Federal Contract Tower,0,0,7,0,7,0,0,55,0,55,0,0,62,0,62,154,0,154,216
12/28/2021,OMN,FL,ASO,ES,Federal Contract Tower,0,0,5,0,5,0,0,56,0,56,0,0,61,0,61,104,0,104,165
12/29/2021,OMN,FL,ASO,ES,Federal Contract Tower,0,0,4,0,4,0,0,86,0,86,0,0,90,0,90,176,0,176,266
12/30/2021,OMN,FL,ASO,ES,Federal Contract Tower,0,0,4,0,4,0,0,52,0,52,0,0,56,0,56,54,0,54,110
12/31/2021,OMN,FL,ASO,ES,Federal Contract Tower,0,0,3,0,3,0,0,4,0,4,0,0,7,0,7,2,0,2,9
01/01/2022,OMN,FL,ASO,ES,Federal Contract Tower,0,0,2,0,2,0,0,11,0,11,0,0,13,0,13,0,0,0,13
01/02/2022,OMN,FL,ASO,ES,Federal Contract Tower,0,0,6,0,6,0,0,20,0,20,0,0,26,0,26,20,0,20,46
01/03/2022,OMN,FL,ASO,ES,Federal Contract Tower,0,0,4,0,4,0,0,25,0,25,0,0,29,0,29,50,0,50,79
01/04/2022,OMN,FL,ASO,ES,Federal Contract Tower,0,0,14,0,14,0,0,88,0,88,0,0,102,0,102,154,0,154,256
01/05/2022,OMN,FL,ASO,ES,Federal Contract Tower,0,0,9,0,9,0,0,85,0,85,0,0,94,0,94,224,0,224,318
01/06/2022,OMN,FL,ASO,ES,Federal Contract Tower,0,0,13,0,13,0,0,88,0,88,0,0,101,0,101,312,0,312,413
01/07/2022,OMN,FL,ASO,ES,Federal Contract Tower,0,0,17,0,17,0,0,92,0,92,0,0,109,0,109,142,0,142,251
01/08/2022,OMN,FL,ASO,ES,Federal Contract Tower,0,0,7,0,7,0,0,72,0,72,0,0,79,0,79,44,0,44,123
01/09/2022,OMN,FL,ASO,ES,Federal Contract Tower,0,0,8,0,8,0,0,72,0,72,0,0,80,0,80,94,0,94,174
01/10/2022,OMN,FL,ASO,ES,Federal Contract Tower,0,0,9,0,9,0,0,40,0,40,0,0,49,0,49,160,0,160,209
01/11/2022,OMN,FL,ASO,ES,Federal Contract Tower,0,0,13,0,13,0,0,77,0,77,0,0,90,0,90,190,0,190,280
01/12/2022,OMN,FL,ASO,ES,Federal Contract Tower,0,0,12,0,12,0,0,152,0,152,0,0,164,0,164,230,0,230,394
01/13/2022,OMN,FL,ASO,ES,Federal Contract Tower,0,0,12,0,12,0,0,172,0,172,0,0,184,0,184,366,0,366,550
01/14/2022,OMN,FL,ASO,ES,Federal Contract Tower,0,0,9,0,9,0,0,146,0,146,0,0,155,0,155,246,0,246,401
01/15/2022,OMN,FL,ASO,ES,Federal Contract Tower,0,0,9,0,9,0,0,76,0,76,0,0,85,0,85,178,0,178,263
01/16/2022,OMN,FL,ASO,ES,Federal Contract Tower,0,0,0,0,0,0,0,0,0,0,0,0,0,0,0,0,0,0,0
01/17/2022,OMN,FL,ASO,ES,Federal Contract Tower,0,0,10,0,10,0,0,33,0,33,0,0,43,0,43,40,0,40,83
01/18/2022,OMN,FL,ASO,ES,Federal Contract Tower,0,0,9,0,9,0,0,167,0,167,0,0,176,0,176,364,0,364,540
01/19/2022,OMN,FL,ASO,ES,Federal Contract Tower,0,0,17,0,17,0,0,152,0,152,0,0,169,0,169,336,0,336,505
01/20/2022,OMN,FL,ASO,ES,Federal Contract Tower,0,0,21,0,21,0,0,140,0,140,0,0,161,0,161,212,0,212,373
01/21/2022,OMN,FL,ASO,ES,Federal Contract Tower,0,0,11,0,11,0,0,70,0,70,0,0,81,0,81,114,0,114,195
01/22/2022,OMN,FL,ASO,ES,Federal Contract Tower,0,0,2,0,2,0,0,0,0,0,0,0,2,0,2,0,0,0,2
01/23/2022,OMN,FL,ASO,ES,Federal Contract Tower,0,0,7,0,7,0,0,17,0,17,0,0,24,0,24,81,0,81,105
01/24/2022,OMN,FL,ASO,ES,Federal Contract Tower,0,0,9,0,9,0,0,110,0,110,0,0,119,0,119,299,0,299,418
01/25/2022,OMN,FL,ASO,ES,Federal Contract Tower,0,0,9,0,9,0,0,56,0,56,0,0,65,0,65,193,0,193,258
01/26/2022,OMN,FL,ASO,ES,Federal Contract Tower,0,0,4,0,4,0,0,7,0,7,0,0,11,0,11,16,0,16,27
01/27/2022,OMN,FL,ASO,ES,Federal Contract Tower,0,0,4,0,4,0,0,0,0,0,0,0,4,0,4,0,0,0,4
01/28/2022,OMN,FL,ASO,ES,Federal Contract Tower,0,0,12,0,12,0,0,65,0,65,0,0,77,0,77,154,0,154,231
01/29/2022,OMN,FL,ASO,ES,Federal Contract Tower,0,0,4,0,4,0,0,9,0,9,0,0,13,0,13,12,0,12,25
01/30/2022,OMN,FL,ASO,ES,Federal Contract Tower,0,0,11,0,11,0,0,82,0,82,0,0,93,0,93,244,0,244,337
01/31/2022,OMN,FL,ASO,ES,Federal Contract Tower,0,0,8,0,8,0,0,134,0,134,0,0,142,0,142,312,0,312,454
02/01/2022,OMN,FL,ASO,ES,Federal Contract Tower,0,0,9,0,9,0,0,169,0,169,0,0,178,0,178,336,0,336,514
02/02/2022,OMN,FL,ASO,ES,Federal Contract Tower,0,0,12,0,12,0,0,106,0,106,0,0,118,0,118,190,0,190,308
02/03/2022,OMN,FL,ASO,ES,Federal Contract Tower,0,0,12,0,12,0,0,114,0,114,0,0,126,0,126,234,0,234,360
02/04/2022,OMN,FL,ASO,ES,Federal Contract Tower,0,0,9,0,9,0,0,123,0,123,0,0,132,0,132,362,0,362,494
02/05/2022,OMN,FL,ASO,ES,Federal Contract Tower,0,0,5,0,5,0,0,26,0,26,0,0,31,0,31,16,0,16,47
02/06/2022,OMN,FL,ASO,ES,Federal Contract Tower,0,0,2,0,2,0,0,0,0,0,0,0,2,0,2,0,0,0,2
02/07/2022,OMN,FL,ASO,ES,Federal Contract Tower,0,0,5,0,5,0,0,0,0,0,0,0,5,0,5,8,0,8,13
02/08/2022,OMN,FL,ASO,ES,Federal Contract Tower,0,0,3,0,3,0,0,0,0,0,0,0,3,0,3,2,0,2,5
02/09/2022,OMN,FL,ASO,ES,Federal Contract Tower,0,0,16,0,16,0,0,160,0,160,0,0,176,0,176,224,0,224,400
02/10/2022,OMN,FL,ASO,ES,Federal Contract Tower,0,0,15,0,15,0,0,171,0,171,0,0,186,0,186,348,0,348,534
02/11/2022,OMN,FL,ASO,ES,Federal Contract Tower,0,0,11,0,11,0,0,130,0,130,0,0,141,0,141,488,0,488,629
02/12/2022,OMN,FL,ASO,ES,Federal Contract Tower,0,0,16,0,16,0,0,110,0,110,0,0,126,0,126,172,0,172,298
02/13/2022,OMN,FL,ASO,ES,Federal Contract Tower,0,0,2,0,2,0,0,7,0,7,0,0,9,0,9,46,0,46,55
02/14/2022,OMN,FL,ASO,ES,Federal Contract Tower,0,0,5,0,5,0,0,118,0,118,0,0,123,0,123,324,0,324,447
02/15/2022,OMN,FL,ASO,ES,Federal Contract Tower,0,0,20,0,20,0,0,169,0,169,0,0,189,0,189,332,0,332,521
02/16/2022,OMN,FL,ASO,ES,Federal Contract Tower,0,0,14,0,14,0,0,91,0,91,0,0,105,0,105,196,0,196,301
02/17/2022,OMN,FL,ASO,ES,Federal Contract Tower,0,0,13,0,13,0,0,87,0,87,0,0,100,0,100,170,0,170,270
02/18/2022,OMN,FL,ASO,ES,Federal Contract Tower,0,0,14,0,14,0,0,58,0,58,0,0,72,0,72,118,0,118,190
02/19/2022,OMN,FL,ASO,ES,Federal Contract Tower,0,0,16,0,16,0,0,95,0,95,0,0,111,0,111,196,0,196,307
02/20/2022,OMN,FL,ASO,ES,Federal Contract Tower,0,0,7,0,7,0,0,59,0,59,0,0,66,0,66,94,0,94,160
02/21/2022,OMN,FL,ASO,ES,Federal Contract Tower,0,0,14,0,14,0,0,146,0,146,0,0,160,0,160,242,0,242,402
02/22/2022,OMN,FL,ASO,ES,Federal Contract Tower,0,0,14,0,14,0,0,134,0,134,0,0,148,0,148,316,0,316,464
02/23/2022,OMN,FL,ASO,ES,Federal Contract Tower,0,0,23,0,23,0,0,176,0,176,0,0,199,0,199,360,0,360,559
02/24/2022,OMN,FL,ASO,ES,Federal Contract Tower,0,0,11,0,11,0,0,138,0,138,0,0,149,0,149,246,0,246,395
02/25/2022,OMN,FL,ASO,ES,Federal Contract Tower,0,0,14,0,14,0,0,112,0,112,0,0,126,0,126,286,0,286,412
02/26/2022,OMN,FL,ASO,ES,Federal Contract Tower,0,0,9,0,9,0,0,127,0,127,0,0,136,0,136,226,0,226,362
02/27/2022,OMN,FL,ASO,ES,Federal Contract Tower,0,0,10,0,10,0,0,63,0,63,0,0,73,0,73,158,0,158,231
02/28/2022,OMN,FL,ASO,ES,Federal Contract Tower,0,0,10,0,10,0,0,1,0,1,0,0,11,0,11,14,0,14,25
03/01/2022,OMN,FL,ASO,ES,Federal Contract Tower,0,0,6,0,6,0,0,33,0,33,0,0,39,0,39,104,0,104,143
03/02/2022,OMN,FL,ASO,ES,Federal Contract Tower,0,0,11,0,11,0,0,199,0,199,0,0,210,0,210,302,0,302,512
03/03/2022,OMN,FL,ASO,ES,Federal Contract Tower,0,0,6,0,6,0,0,142,0,142,0,0,148,0,148,242,0,242,390
03/04/2022,OMN,FL,ASO,ES,Federal Contract Tower,0,0,16,0,16,0,0,187,0,187,0,0,203,0,203,324,0,324,527
03/05/2022,OMN,FL,ASO,ES,Federal Contract Tower,0,0,12,0,12,0,0,88,0,88,0,0,100,0,100,118,0,118,218
03/06/2022,OMN,FL,ASO,ES,Federal Contract Tower,0,0,0,0,0,0,0,45,0,45,0,0,45,0,45,50,0,50,95
03/07/2022,OMN,FL,ASO,ES,Federal Contract Tower,0,0,10,0,10,0,0,112,0,112,0,0,122,0,122,383,0,383,505
03/08/2022,OMN,FL,ASO,ES,Federal Contract Tower,0,0,12,0,12,0,0,18,0,18,0,0,30,0,30,50,0,50,80
03/09/2022,OMN,FL,ASO,ES,Federal Contract Tower,0,0,10,0,10,0,0,10,0,10,0,0,20,0,20,32,0,32,52
03/10/2022,OMN,FL,ASO,ES,Federal Contract Tower,0,0,10,0,10,0,0,46,0,46,0,0,56,0,56,158,0,158,214
03/11/2022,OMN,FL,ASO,ES,Federal Contract Tower,0,0,6,0,6,0,0,28,0,28,0,0,34,0,34,80,0,80,114
03/12/2022,OMN,FL,ASO,ES,Federal Contract Tower,0,0,0,0,0,0,0,2,0,2,0,0,2,0,2,6,0,6,8
03/13/2022,OMN,FL,ASO,ES,Federal Contract Tower,0,0,12,0,12,0,0,98,0,98,0,0,110,0,110,224,0,224,334
03/14/2022,OMN,FL,ASO,ES,Federal Contract Tower,0,0,31,0,31,0,0,126,0,126,0,0,157,0,157,300,0,300,457
03/15/2022,OMN,FL,ASO,ES,Federal Contract Tower,0,0,9,0,9,0,0,72,0,72,0,0,81,0,81,230,0,230,311
03/16/2022,OMN,FL,ASO,ES,Federal Contract Tower,0,0,8,0,8,0,0,86,0,86,0,0,94,0,94,112,0,112,206
03/17/2022,OMN,FL,ASO,ES,Federal Contract Tower,0,0,14,0,14,0,0,200,0,200,0,0,214,0,214,324,0,324,538
03/18/2022,OMN,FL,ASO,ES,Federal Contract Tower,0,0,16,0,16,0,0,74,0,74,0,0,90,0,90,256,0,256,346
03/19/2022,OMN,FL,ASO,ES,Federal Contract Tower,0,0,12,0,12,0,0,88,0,88,0,0,100,0,100,230,0,230,330
03/20/2022,OMN,FL,ASO,ES,Federal Contract Tower,0,0,6,0,6,0,0,58,0,58,0,0,64,0,64,196,0,196,260
03/21/2022,OMN,FL,ASO,ES,Federal Contract Tower,0,0,10,0,10,0,0,146,0,146,0,0,156,0,156,262,0,262,418
03/22/2022,OMN,FL,ASO,ES,Federal Contract Tower,0,0,13,0,13,0,0,162,0,162,0,0,175,0,175,228,0,228,403
03/23/2022,OMN,FL,ASO,ES,Federal Contract Tower,0,0,6,0,6,0,0,78,0,78,0,0,84,0,84,82,0,82,166
03/24/2022,OMN,FL,ASO,ES,Federal Contract Tower,0,0,3,0,3,0,0,12,0,12,0,0,15,0,15,4,0,4,19
03/25/2022,OMN,FL,ASO,ES,Federal Contract Tower,0,0,17,0,17,0,0,165,0,165,0,0,182,0,182,244,0,244,426
03/26/2022,OMN,FL,ASO,ES,Federal Contract Tower,0,0,11,0,11,0,0,98,0,98,0,0,109,0,109,184,0,184,293
03/27/2022,OMN,FL,ASO,ES,Federal Contract Tower,0,0,8,0,8,0,0,65,0,65,0,0,73,0,73,140,0,140,213
03/28/2022,OMN,FL,ASO,ES,Federal Contract Tower,0,0,8,0,8,0,0,144,0,144,0,0,152,0,152,416,0,416,568
03/29/2022,OMN,FL,ASO,ES,Federal Contract Tower,0,0,10,0,10,0,0,178,0,178,0,0,188,0,188,352,0,352,540
03/30/2022,OMN,FL,ASO,ES,Federal Contract Tower,0,0,14,0,14,0,0,84,0,84,0,0,98,0,98,258,0,258,356
03/31/2022,OMN,FL,ASO,ES,Federal Contract Tower,0,0,9,0,9,0,0,63,0,63,0,0,72,0,72,104,0,104,176
04/01/2022,OMN,FL,ASO,ES,Federal Contract Tower,0,0,11,0,11,0,0,71,0,71,0,0,82,0,82,270,0,270,352
04/02/2022,OMN,FL,ASO,ES,Federal Contract Tower,0,0,1,0,1,0,0,0,0,0,0,0,1,0,1,0,0,0,1
04/03/2022,OMN,FL,ASO,ES,Federal Contract Tower,0,0,7,0,7,0,0,79,0,79,0,0,86,0,86,222,0,222,308
04/04/2022,OMN,FL,ASO,ES,Federal Contract Tower,0,0,15,0,15,0,0,165,0,165,0,0,180,0,180,404,0,404,584
04/05/2022,OMN,FL,ASO,ES,Federal Contract Tower,0,0,8,0,8,0,0,137,0,137,0,0,145,0,145,282,0,282,427
04/06/2022,OMN,FL,ASO,ES,Federal Contract Tower,0,0,11,0,11,0,0,190,0,190,0,0,201,0,201,230,0,230,431
04/07/2022,OMN,FL,ASO,ES,Federal Contract Tower,0,0,11,0,11,0,0,26,0,26,0,0,37,0,37,114,0,114,151
04/08/2022,OMN,FL,ASO,ES,Federal Contract Tower,0,0,10,0,10,0,0,124,0,124,0,0,134,0,134,156,0,156,290
04/09/2022,OMN,FL,ASO,ES,Federal Contract Tower,0,0,5,0,5,0,0,124,0,124,0,0,129,0,129,154,0,154,283
04/10/2022,OMN,FL,ASO,ES,Federal Contract Tower,0,0,11,0,11,0,0,112,0,112,0,0,123,0,123,341,0,341,464
04/11/2022,OMN,FL,ASO,ES,Federal Contract Tower,0,0,5,0,5,0,0,153,0,153,0,0,158,0,158,367,0,367,525
04/12/2022,OMN,FL,ASO,ES,Federal Contract Tower,0,0,9,0,9,0,0,158,0,158,0,0,167,0,167,320,0,320,487
04/13/2022,OMN,FL,ASO,ES,Federal Contract Tower,0,0,19,0,19,0,0,176,0,176,0,0,195,0,195,364,0,364,559
04/14/2022,OMN,FL,ASO,ES,Federal Contract Tower,0,0,12,0,12,0,0,168,0,168,0,0,180,0,180,400,0,400,580
04/15/2022,OMN,FL,ASO,ES,Federal Contract Tower,0,0,15,0,15,0,0,113,0,113,0,0,128,0,128,70,0,70,198
04/16/2022,OMN,FL,ASO,ES,Federal Contract Tower,0,0,16,0,16,0,0,143,0,143,0,0,159,0,159,240,0,240,399
04/17/2022,OMN,FL,ASO,ES,Federal Contract Tower,0,0,4,0,4,0,0,69,0,69,0,0,73,0,73,126,0,126,199
04/18/2022,OMN,FL,ASO,ES,Federal Contract Tower,0,0,14,0,14,0,0,70,0,70,0,0,84,0,84,252,0,252,336
04/19/2022,OMN,FL,ASO,ES,Federal Contract Tower,0,0,13,0,13,0,0,136,0,136,0,0,149,0,149,200,0,200,349
04/20/2022,OMN,FL,ASO,ES,Federal Contract Tower,0,0,11,0,11,0,0,104,0,104,0,0,115,0,115,168,0,168,283
04/21/2022,OMN,FL,ASO,ES,Federal Contract Tower,0,0,4,0,4,0,0,83,0,83,0,0,87,0,87,222,0,222,309
04/22/2022,OMN,FL,ASO,ES,Federal Contract Tower,0,0,16,0,16,0,0,90,0,90,0,0,106,0,106,280,0,280,386
04/23/2022,OMN,FL,ASO,ES,Federal Contract Tower,0,0,10,0,10,0,0,61,0,61,0,0,71,0,71,106,0,106,177
04/24/2022,OMN,FL,ASO,ES,Federal Contract Tower,0,0,7,0,7,0,0,57,0,57,0,0,64,0,64,74,0,74,138
04/25/2022,OMN,FL,ASO,ES,Federal Contract Tower,0,0,14,0,14,0,0,150,0,150,0,0,164,0,164,160,0,160,324
04/26/2022,OMN,FL,ASO,ES,Federal Contract Tower,0,0,14,0,14,0,0,183,0,183,0,0,197,0,197,300,0,300,497
04/27/2022,OMN,FL,ASO,ES,Federal Contract Tower,0,0,10,0,10,0,0,174,0,174,0,0,184,0,184,196,0,196,380
04/28/2022,OMN,FL,ASO,ES,Federal Contract Tower,0,0,19,0,19,0,0,82,0,82,0,0,101,0,101,90,0,90,191
04/29/2022,OMN,FL,ASO,ES,Federal Contract Tower,0,0,17,0,17,0,0,99,0,99,0,0,116,0,116,182,0,182,298
04/30/2022,OMN,FL,ASO,ES,Federal Contract Tower,0,0,7,0,7,0,0,123,0,123,0,0,130,0,130,196,0,196,326
05/01/2022,OMN,FL,ASO,ES,Federal Contract Tower,0,0,10,0,10,0,0,58,0,58,0,0,68,0,68,100,0,100,168
05/02/2022,OMN,FL,ASO,ES,Federal Contract Tower,0,0,23,0,23,0,0,142,0,142,0,0,165,0,165,246,0,246,411
05/03/2022,OMN,FL,ASO,ES,Federal Contract Tower,0,0,11,0,11,0,0,150,0,150,0,0,161,0,161,332,0,332,493
05/04/2022,OMN,FL,ASO,ES,Federal Contract Tower,0,0,5,0,5,0,0,197,0,197,0,0,202,0,202,230,0,230,432
05/05/2022,OMN,FL,ASO,ES,Federal Contract Tower,0,0,12,0,12,0,0,191,0,191,0,0,203,0,203,236,0,236,439
05/06/2022,OMN,FL,ASO,ES,Federal Contract Tower,0,0,10,0,10,0,0,101,0,101,0,0,111,0,111,204,0,204,315
05/07/2022,OMN,FL,ASO,ES,Federal Contract Tower,0,0,5,0,5,0,0,43,0,43,0,0,48,0,48,34,0,34,82
05/08/2022,OMN,FL,ASO,ES,Federal Contract Tower,0,0,6,0,6,0,0,43,0,43,0,0,49,0,49,138,0,138,187
05/09/2022,OMN,FL,ASO,ES,Federal Contract Tower,0,0,21,0,21,0,0,90,0,90,0,0,111,0,111,126,0,126,237
05/10/2022,OMN,FL,ASO,ES,Federal Contract Tower,0,0,10,0,10,0,0,77,0,77,0,0,87,0,87,124,0,124,211
05/11/2022,OMN,FL,ASO,ES,Federal Contract Tower,0,0,8,0,8,0,0,72,0,72,0,0,80,0,80,148,0,148,228
05/12/2022,OMN,FL,ASO,ES,Federal Contract Tower,0,0,16,0,16,0,0,87,0,87,0,0,103,0,103,192,0,192,295
05/13/2022,OMN,FL,ASO,ES,Federal Contract Tower,0,0,13,0,13,0,0,157,0,157,0,0,170,0,170,296,0,296,466
05/14/2022,OMN,FL,ASO,ES,Federal Contract Tower,0,0,12,0,12,0,0,202,0,202,0,0,214,0,214,274,0,274,488
05/15/2022,OMN,FL,ASO,ES,Federal Contract Tower,0,0,4,0,4,0,0,40,0,40,0,0,44,0,44,82,0,82,126
05/16/2022,OMN,FL,ASO,ES,Federal Contract Tower,0,0,11,0,11,0,0,65,0,65,0,0,76,0,76,206,0,206,282
05/17/2022,OMN,FL,ASO,ES,Federal Contract Tower,0,0,8,0,8,0,0,105,0,105,0,0,113,0,113,214,0,214,327
05/18/2022,OMN,FL,ASO,ES,Federal Contract Tower,0,0,16,0,16,0,0,145,0,145,0,0,161,0,161,186,0,186,347
05/19/2022,OMN,FL,ASO,ES,Federal Contract Tower,0,0,17,0,17,0,0,191,0,191,0,0,208,0,208,266,0,266,474
05/20/2022,OMN,FL,ASO,ES,Federal Contract Tower,0,0,12,0,12,0,0,102,0,102,0,0,114,0,114,292,0,292,406
05/21/2022,OMN,FL,ASO,ES,Federal Contract Tower,0,0,5,0,5,0,0,40,0,40,0,0,45,0,45,134,0,134,179
05/22/2022,OMN,FL,ASO,ES,Federal Contract Tower,0,0,15,0,15,0,0,16,0,16,0,0,31,0,31,46,0,46,77
05/23/2022,OMN,FL,ASO,ES,Federal Contract Tower,0,0,16,0,16,0,0,109,0,109,0,0,125,0,125,226,0,226,351
05/24/2022,OMN,FL,ASO,ES,Federal Contract Tower,0,0,15,0,15,0,0,137,0,137,0,0,152,0,152,240,0,240,392
05/25/2022,OMN,FL,ASO,ES,Federal Contract Tower,0,0,12,0,12,0,0,99,0,99,0,0,111,0,111,86,0,86,197
05/26/2022,OMN,FL,ASO,ES,Federal Contract Tower,0,0,13,0,13,0,0,99,0,99,0,0,112,0,112,124,0,124,236
05/27/2022,OMN,FL,ASO,ES,Federal Contract Tower,0,0,14,0,14,0,0,109,0,109,0,0,123,0,123,138,0,138,261
05/28/2022,OMN,FL,ASO,ES,Federal Contract Tower,0,0,8,0,8,0,0,89,0,89,0,0,97,0,97,92,0,92,189
05/29/2022,OMN,FL,ASO,ES,Federal Contract Tower,0,0,4,0,4,0,0,42,0,42,0,0,46,0,46,80,0,80,126
05/30/2022,OMN,FL,ASO,ES,Federal Contract Tower,0,0,10,0,10,0,0,112,0,112,0,0,122,0,122,338,0,338,460
05/31/2022,OMN,FL,ASO,ES,Federal Contract Tower,0,0,14,0,14,0,0,117,0,117,0,0,131,0,131,156,0,156,287
06/01/2022,OMN,FL,ASO,ES,Federal Contract Tower,0,0,16,0,16,0,0,124,0,124,0,0,140,0,140,136,0,136,276
06/02/2022,OMN,FL,ASO,ES,Federal Contract Tower,0,0,19,0,19,0,0,170,0,170,0,0,189,0,189,240,0,240,429
06/03/2022,OMN,FL,ASO,ES,Federal Contract Tower,0,0,11,0,11,0,0,168,0,168,0,0,179,0,179,242,0,242,421
06/04/2022,OMN,FL,ASO,ES,Federal Contract Tower,0,0,4,0,4,0,0,14,0,14,0,0,18,0,18,24,0,24,42
06/05/2022,OMN,FL,ASO,ES,Federal Contract Tower,0,0,5,0,5,0,0,31,0,31,0,0,36,0,36,68,0,68,104
06/06/2022,OMN,FL,ASO,ES,Federal Contract Tower,0,0,6,0,6,0,0,102,0,102,0,0,108,0,108,164,0,164,272
06/07/2022,OMN,FL,ASO,ES,Federal Contract Tower,0,0,16,0,16,0,0,122,0,122,0,0,138,0,138,218,0,218,356
06/08/2022,OMN,FL,ASO,ES,Federal Contract Tower,0,0,7,0,7,0,0,124,0,124,0,0,131,0,131,195,0,195,326
06/09/2022,OMN,FL,ASO,ES,Federal Contract Tower,0,0,14,0,14,0,0,110,0,110,0,0,124,0,124,190,0,190,314
06/10/2022,OMN,FL,ASO,ES,Federal Contract Tower,0,0,2,0,2,0,0,60,0,60,0,0,62,0,62,76,0,76,138
06/11/2022,OMN,FL,ASO,ES,Federal Contract Tower,0,0,8,0,8,0,0,59,0,59,0,0,67,0,67,114,0,114,181
06/12/2022,OMN,FL,ASO,ES,Federal Contract Tower,0,0,5,0,5,0,0,43,0,43,0,0,48,0,48,42,0,42,90
06/13/2022,OMN,FL,ASO,ES,Federal Contract Tower,0,0,14,0,14,0,0,77,0,77,0,0,91,0,91,124,0,124,215
06/14/2022,OMN,FL,ASO,ES,Federal Contract Tower,0,0,12,1,13,0,0,104,0,104,0,0,116,1,117,190,2,192,309
06/15/2022,OMN,FL,ASO,ES,Federal Contract Tower,0,0,13,0,13,0,0,159,0,159,0,0,172,0,172,154,0,154,326
06/16/2022,OMN,FL,ASO,ES,Federal Contract Tower,0,0,15,0,15,0,0,129,0,129,0,0,144,0,144,282,0,282,426
06/17/2022,OMN,FL,ASO,ES,Federal Contract Tower,0,0,7,0,7,0,0,98,0,98,0,0,105,0,105,170,0,170,275
06/18/2022,OMN,FL,ASO,ES,Federal Contract Tower,0,0,7,0,7,0,0,75,0,75,0,0,82,0,82,62,0,62,144
06/19/2022,OMN,FL,ASO,ES,Federal Contract Tower,0,0,6,0,6,0,0,49,0,49,0,0,55,0,55,92,0,92,147
06/20/2022,OMN,FL,ASO,ES,Federal Contract Tower,0,0,20,0,20,0,0,60,0,60,0,0,80,0,80,150,0,150,230
06/21/2022,OMN,FL,ASO,ES,Federal Contract Tower,0,0,12,0,12,0,0,94,0,94,0,0,106,0,106,100,0,100,206
06/22/2022,OMN,FL,ASO,ES,Federal Contract Tower,0,0,12,0,12,0,0,96,0,96,0,0,108,0,108,172,0,172,280
06/23/2022,OMN,FL,ASO,ES,Federal Contract Tower,0,0,9,0,9,0,0,93,0,93,0,0,102,0,102,162,0,162,264
06/24/2022,OMN,FL,ASO,ES,Federal Contract Tower,0,0,7,0,7,0,0,14,0,14,0,0,21,0,21,18,0,18,39
06/25/2022,OMN,FL,ASO,ES,Federal Contract Tower,0,0,8,0,8,0,0,58,0,58,0,0,66,0,66,22,0,22,88
06/26/2022,OMN,FL,ASO,ES,Federal Contract Tower,0,0,4,0,4,0,0,48,0,48,0,0,52,0,52,46,0,46,98
06/27/2022,OMN,FL,ASO,ES,Federal Contract Tower,0,0,9,0,9,0,0,57,0,57,0,0,66,0,66,102,0,102,168
06/28/2022,OMN,FL,ASO,ES,Federal Contract Tower,0,0,10,0,10,0,0,134,0,134,0,0,144,0,144,146,0,146,290
06/29/2022,OMN,FL,ASO,ES,Federal Contract Tower,0,0,18,0,18,0,0,171,0,171,0,0,189,0,189,190,0,190,379
06/30/2022,OMN,FL,ASO,ES,Federal Contract Tower,0,0,7,0,7,0,0,69,0,69,0,0,76,0,76,132,0,132,208
07/01/2022,OMN,FL,ASO,ES,Federal Contract Tower,0,0,18,0,18,0,0,91,0,91,0,0,109,0,109,96,0,96,205
07/02/2022,OMN,FL,ASO,ES,Federal Contract Tower,0,0,1,0,1,0,0,68,0,68,0,0,69,0,69,144,0,144,213
07/03/2022,OMN,FL,ASO,ES,Federal Contract Tower,0,0,2,0,2,0,0,25,0,25,0,0,27,0,27,116,0,116,143
07/04/2022,OMN,FL,ASO,ES,Federal Contract Tower,0,0,10,0,10,0,0,54,0,54,0,0,64,0,64,80,0,80,144
07/05/2022,OMN,FL,ASO,ES,Federal Contract Tower,0,0,20,0,20,0,0,122,0,122,0,0,142,0,142,222,0,222,364
07/06/2022,OMN,FL,ASO,ES,Federal Contract Tower,0,0,14,0,14,0,0,109,0,109,0,0,123,0,123,174,0,174,297
07/07/2022,OMN,FL,ASO,ES,Federal Contract Tower,0,0,19,0,19,0,0,68,0,68,0,0,87,0,87,166,0,166,253
07/08/2022,OMN,FL,ASO,ES,Federal Contract Tower,0,0,13,0,13,0,0,86,0,86,0,0,99,0,99,206,0,206,305
07/09/2022,OMN,FL,ASO,ES,Federal Contract Tower,0,0,6,0,6,0,0,48,0,48,0,0,54,0,54,152,0,152,206
07/10/2022,OMN,FL,ASO,ES,Federal Contract Tower,0,0,4,0,4,0,0,45,0,45,0,0,49,0,49,114,0,114,163
07/11/2022,OMN,FL,ASO,ES,Federal Contract Tower,0,0,18,0,18,0,0,61,0,61,0,0,79,0,79,114,0,114,193
07/12/2022,OMN,FL,ASO,ES,Federal Contract Tower,0,0,7,0,7,0,0,77,0,77,0,0,84,0,84,162,0,162,246
07/13/2022,OMN,FL,ASO,ES,Federal Contract Tower,0,0,12,0,12,0,0,99,0,99,0,0,111,0,111,102,0,102,213
07/14/2022,OMN,FL,ASO,ES,Federal Contract Tower,0,0,21,0,21,0,0,101,0,101,0,0,122,0,122,200,0,200,322
07/15/2022,OMN,FL,ASO,ES,Federal Contract Tower,0,0,15,0,15,0,0,67,0,67,0,0,82,0,82,86,0,86,168
07/16/2022,OMN,FL,ASO,ES,Federal Contract Tower,0,0,12,0,12,0,0,46,0,46,0,0,58,0,58,18,0,18,76
07/17/2022,OMN,FL,ASO,ES,Federal Contract Tower,0,0,5,0,5,0,0,35,0,35,0,0,40,0,40,48,0,48,88
07/18/2022,OMN,FL,ASO,ES,Federal Contract Tower,0,0,11,0,11,0,0,53,0,53,0,0,64,0,64,128,0,128,192
07/19/2022,OMN,FL,ASO,ES,Federal Contract Tower,0,0,12,0,12,0,0,114,0,114,0,0,126,0,126,172,0,172,298
07/20/2022,OMN,FL,ASO,ES,Federal Contract Tower,0,0,10,0,10,0,0,135,0,135,0,0,145,0,145,180,0,180,325
07/21/2022,OMN,FL,ASO,ES,Federal Contract Tower,0,0,16,0,16,0,0,122,0,122,0,0,138,0,138,120,0,120,258
07/22/2022,OMN,FL,ASO,ES,Federal Contract Tower,0,0,20,0,20,0,0,114,0,114,0,0,134,0,134,170,0,170,304
07/23/2022,OMN,FL,ASO,ES,Federal Contract Tower,0,0,13,0,13,0,0,88,0,88,0,0,101,0,101,228,0,228,329
07/24/2022,OMN,FL,ASO,ES,Federal Contract Tower,0,0,9,0,9,0,0,68,0,68,0,0,77,0,77,104,0,104,181
07/25/2022,OMN,FL,ASO,ES,Federal Contract Tower,0,0,19,0,19,0,0,99,0,99,0,0,118,0,118,172,0,172,290
07/26/2022,OMN,FL,ASO,ES,Federal Contract Tower,0,0,16,0,16,0,0,75,0,75,0,0,91,0,91,82,0,82,173
07/27/2022,OMN,FL,ASO,ES,Federal Contract Tower,0,0,8,0,8,0,0,127,0,127,0,0,135,0,135,140,0,140,275
07/28/2022,OMN,FL,ASO,ES,Federal Contract Tower,0,0,12,0,12,0,0,133,0,133,0,0,145,0,145,236,0,236,381
07/29/2022,OMN,FL,ASO,ES,Federal Contract Tower,0,0,19,0,19,0,0,150,0,150,0,0,169,0,169,204,0,204,373
07/30/2022,OMN,FL,ASO,ES,Federal Contract Tower,0,0,8,0,8,0,0,96,0,96,0,0,104,0,104,142,0,142,246
07/31/2022,OMN,FL,ASO,ES,Federal Contract Tower,0,0,1,0,1,0,0,43,0,43,0,0,44,0,44,94,0,94,138
08/01/2022,OMN,FL,ASO,ES,Federal Contract Tower,0,0,13,0,13,0,0,63,0,63,0,0,76,0,76,152,0,152,228
08/02/2022,OMN,FL,ASO,ES,Federal Contract Tower,0,0,14,0,14,0,0,122,0,122,0,0,136,0,136,116,0,116,252
08/03/2022,OMN,FL,ASO,ES,Federal Contract Tower,0,0,13,0,13,0,0,127,0,127,0,0,140,0,140,140,0,140,280
08/04/2022,OMN,FL,ASO,ES,Federal Contract Tower,0,0,18,0,18,0,0,78,0,78,0,0,96,0,96,180,0,180,276
08/05/2022,OMN,FL,ASO,ES,Federal Contract Tower,0,0,4,0,4,0,0,66,0,66,0,0,70,0,70,140,0,140,210
08/06/2022,OMN,FL,ASO,ES,Federal Contract Tower,0,0,10,0,10,0,0,72,0,72,0,0,82,0,82,108,0,108,190
08/07/2022,OMN,FL,ASO,ES,Federal Contract Tower,0,0,6,0,6,0,0,27,0,27,0,0,33,0,33,24,0,24,57
08/08/2022,OMN,FL,ASO,ES,Federal Contract Tower,0,0,11,0,11,0,0,52,0,52,0,0,63,0,63,160,0,160,223
08/09/2022,OMN,FL,ASO,ES,Federal Contract Tower,0,0,12,0,12,0,0,61,0,61,0,0,73,0,73,120,0,120,193
08/10/2022,OMN,FL,ASO,ES,Federal Contract Tower,0,0,19,0,19,0,0,130,0,130,0,0,149,0,149,180,0,180,329
08/11/2022,OMN,FL,ASO,ES,Federal Contract Tower,0,0,7,0,7,0,0,61,0,61,0,0,68,0,68,124,0,124,192
08/12/2022,OMN,FL,ASO,ES,Federal Contract Tower,0,0,11,0,11,0,0,104,0,104,0,0,115,0,115,188,0,188,303
08/13/2022,OMN,FL,ASO,ES,Federal Contract Tower,0,0,7,0,7,0,0,59,0,59,0,0,66,0,66,82,0,82,148
08/14/2022,OMN,FL,ASO,ES,Federal Contract Tower,0,0,13,0,13,0,0,34,0,34,0,0,47,0,47,52,0,52,99
08/15/2022,OMN,FL,ASO,ES,Federal Contract Tower,0,0,17,0,17,0,0,83,0,83,0,0,100,0,100,98,0,98,198
08/16/2022,OMN,FL,ASO,ES,Federal Contract Tower,0,0,18,0,18,0,0,99,0,99,0,0,117,0,117,292,0,292,409
08/17/2022,OMN,FL,ASO,ES,Federal Contract Tower,0,0,9,0,9,0,0,109,0,109,0,0,118,0,118,116,0,116,234
08/18/2022,OMN,FL,ASO,ES,Federal Contract Tower,0,0,14,0,14,0,0,92,0,92,0,0,106,0,106,182,0,182,288
08/19/2022,OMN,FL,ASO,ES,Federal Contract Tower,0,0,20,0,20,0,0,104,0,104,0,0,124,0,124,200,0,200,324
08/20/2022,OMN,FL,ASO,ES,Federal Contract Tower,0,0,11,0,11,0,0,89,0,89,0,0,100,0,100,170,0,170,270
08/21/2022,OMN,FL,ASO,ES,Federal Contract Tower,0,2,2,0,4,0,0,33,0,33,0,2,35,0,37,34,0,34,71
08/22/2022,OMN,FL,ASO,ES,Federal Contract Tower,0,0,15,0,15,0,0,77,0,77,0,0,92,0,92,118,0,118,210
08/23/2022,OMN,FL,ASO,ES,Federal Contract Tower,0,0,2,0,2,0,0,60,0,60,0,0,62,0,62,64,0,64,126
08/24/2022,OMN,FL,ASO,ES,Federal Contract Tower,0,0,15,0,15,0,0,100,0,100,0,0,115,0,115,128,0,128,243
08/25/2022,OMN,FL,ASO,ES,Federal Contract Tower,0,0,10,0,10,0,0,74,0,74,0,0,84,0,84,142,0,142,226
08/26/2022,OMN,FL,ASO,ES,Federal Contract Tower,0,0,8,0,8,0,0,59,0,59,0,0,67,0,67,90,0,90,157
08/27/2022,OMN,FL,ASO,ES,Federal Contract Tower,0,0,9,0,9,0,0,80,0,80,0,0,89,0,89,44,0,44,133
08/28/2022,OMN,FL,ASO,ES,Federal Contract Tower,0,0,1,0,1,0,0,41,0,41,0,0,42,0,42,68,0,68,110
08/29/2022,OMN,FL,ASO,ES,Federal Contract Tower,0,0,9,0,9,0,0,65,0,65,0,0,74,0,74,86,0,86,160
08/30/2022,OMN,FL,ASO,ES,Federal Contract Tower,0,0,15,0,15,0,0,87,0,87,0,0,102,0,102,148,0,148,250
08/31/2022,OMN,FL,ASO,ES,Federal Contract Tower,0,0,12,0,12,0,0,99,0,99,0,0,111,0,111,76,0,76,187
09/01/2022,OMN,FL,ASO,ES,Federal Contract Tower,0,0,21,0,21,0,0,120,0,120,0,0,141,0,141,200,0,200,341
09/02/2022,OMN,FL,ASO,ES,Federal Contract Tower,0,0,8,0,8,0,0,54,0,54,0,0,62,0,62,56,0,56,118
09/03/2022,OMN,FL,ASO,ES,Federal Contract Tower,0,0,6,0,6,0,0,68,0,68,0,0,74,0,74,78,0,78,152
09/04/2022,OMN,FL,ASO,ES,Federal Contract Tower,0,0,4,0,4,0,0,51,0,51,0,0,55,0,55,84,0,84,139
09/05/2022,OMN,FL,ASO,ES,Federal Contract Tower,0,0,8,0,8,0,0,56,0,56,0,0,64,0,64,42,0,42,106
09/06/2022,OMN,FL,ASO,ES,Federal Contract Tower,0,0,7,0,7,0,0,58,0,58,0,0,65,0,65,139,0,139,204
09/07/2022,OMN,FL,ASO,ES,Federal Contract Tower,0,0,9,0,9,0,0,138,0,138,0,0,147,0,147,170,0,170,317
09/08/2022,OMN,FL,ASO,ES,Federal Contract Tower,0,0,13,0,13,0,0,94,0,94,0,0,107,0,107,122,0,122,229
09/09/2022,OMN,FL,ASO,ES,Federal Contract Tower,0,0,10,0,10,0,0,67,0,67,0,0,77,0,77,156,0,156,233
09/10/2022,OMN,FL,ASO,ES,Federal Contract Tower,0,0,9,0,9,0,0,87,0,87,0,0,96,0,96,118,0,118,214
09/11/2022,OMN,FL,ASO,ES,Federal Contract Tower,0,0,7,0,7,0,0,51,0,51,0,0,58,0,58,66,0,66,124
09/12/2022,OMN,FL,ASO,ES,Federal Contract Tower,0,0,8,0,8,0,0,74,0,74,0,0,82,0,82,132,0,132,214
09/13/2022,OMN,FL,ASO,ES,Federal Contract Tower,0,0,8,0,8,0,0,56,0,56,0,0,64,0,64,148,0,148,212
09/14/2022,OMN,FL,ASO,ES,Federal Contract Tower,0,0,10,0,10,0,0,116,0,116,0,0,126,0,126,120,0,120,246
09/15/2022,OMN,FL,ASO,ES,Federal Contract Tower,0,0,14,0,14,0,0,118,0,118,0,0,132,0,132,90,0,90,222
09/16/2022,OMN,FL,ASO,ES,Federal Contract Tower,0,0,11,0,11,0,0,75,0,75,0,0,86,0,86,98,0,98,184
09/17/2022,OMN,FL,ASO,ES,Federal Contract Tower,0,0,8,0,8,0,0,19,0,19,0,0,27,0,27,36,0,36,63
09/18/2022,OMN,FL,ASO,ES,Federal Contract Tower,0,0,7,0,7,0,0,29,0,29,0,0,36,0,36,20,0,20,56
09/19/2022,OMN,FL,ASO,ES,Federal Contract Tower,0,0,11,0,11,0,0,103,0,103,0,0,114,0,114,142,0,142,256
09/20/2022,OMN,FL,ASO,ES,Federal Contract Tower,0,0,11,0,11,0,0,62,0,62,0,0,73,0,73,114,0,114,187
09/21/2022,OMN,FL,ASO,ES,Federal Contract Tower,0,0,14,0,14,0,0,95,0,95,0,0,109,0,109,58,0,58,167
09/22/2022,OMN,FL,ASO,ES,Federal Contract Tower,0,0,17,0,17,0,0,88,0,88,0,0,105,0,105,104,0,104,209
09/23/2022,OMN,FL,ASO,ES,Federal Contract Tower,0,0,14,0,14,0,0,56,0,56,0,0,70,0,70,58,0,58,128
09/24/2022,OMN,FL,ASO,ES,Federal Contract Tower,0,0,7,0,7,0,0,61,0,61,0,0,68,0,68,132,0,132,200
09/25/2022,OMN,FL,ASO,ES,Federal Contract Tower,0,0,6,0,6,0,0,44,0,44,0,0,50,0,50,95,0,95,145
09/26/2022,OMN,FL,ASO,ES,Federal Contract Tower,0,0,5,0,5,0,0,108,0,108,0,0,113,0,113,78,0,78,191
09/27/2022,OMN,FL,ASO,ES,Federal Contract Tower,0,0,2,0,2,0,0,71,0,71,0,0,73,0,73,60,0,60,133
09/28/2022,OMN,FL,ASO,ES,Federal Contract Tower,0,0,0,0,0,0,0,0,0,0,0,0,0,0,0,0,0,0,0
09/29/2022,OMN,FL,ASO,ES,Federal Contract Tower,0,0,0,0,0,0,0,0,0,0,0,0,0,0,0,0,0,0,0
09/30/2022,OMN,FL,ASO,ES,Federal Contract Tower,0,0,0,0,0,0,0,0,0,0,0,0,0,0,0,0,0,0,0
10/01/2022,OMN,FL,ASO,ES,Federal Contract Tower,0,0,0,0,0,0,0,13,0,13,0,0,13,0,13,24,0,24,37
10/02/2022,OMN,FL,ASO,ES,Federal Contract Tower,0,0,3,0,3,0,0,40,0,40,0,0,43,0,43,40,0,40,83
10/03/2022,OMN,FL,ASO,ES,Federal Contract Tower,0,0,14,0,14,0,0,128,0,128,0,0,142,0,142,244,0,244,386
10/04/2022,OMN,FL,ASO,ES,Federal Contract Tower,0,0,9,0,9,0,0,145,0,145,0,0,154,0,154,198,0,198,352
10/05/2022,OMN,FL,ASO,ES,Federal Contract Tower,0,0,11,0,11,0,0,147,0,147,0,0,158,0,158,336,0,336,494
10/06/2022,OMN,FL,ASO,ES,Federal Contract Tower,0,0,10,0,10,0,0,127,0,127,0,0,137,0,137,280,0,280,417
10/07/2022,OMN,FL,ASO,ES,Federal Contract Tower,0,0,15,0,15,0,0,138,0,138,0,0,153,0,153,331,0,331,484
10/08/2022,OMN,FL,ASO,ES,Federal Contract Tower,0,0,4,0,4,0,0,59,0,59,0,0,63,0,63,186,0,186,249
10/09/2022,OMN,FL,ASO,ES,Federal Contract Tower,0,0,5,0,5,0,0,40,0,40,0,0,45,0,45,54,0,54,99
10/10/2022,OMN,FL,ASO,ES,Federal Contract Tower,0,0,13,0,13,0,0,98,0,98,0,0,111,0,111,240,0,240,351
10/11/2022,OMN,FL,ASO,ES,Federal Contract Tower,0,0,7,0,7,0,0,130,0,130,0,0,137,0,137,244,0,244,381
10/12/2022,OMN,FL,ASO,ES,Federal Contract Tower,0,0,10,0,10,0,0,144,0,144,0,0,154,0,154,278,0,278,432
10/13/2022,OMN,FL,ASO,ES,Federal Contract Tower,0,0,14,0,14,0,0,165,0,165,0,0,179,0,179,232,0,232,411
10/14/2022,OMN,FL,ASO,ES,Federal Contract Tower,0,0,11,0,11,0,0,133,0,133,0,0,144,0,144,248,0,248,392
10/15/2022,OMN,FL,ASO,ES,Federal Contract Tower,0,0,7,0,7,0,0,95,0,95,0,0,102,0,102,232,0,232,334
10/16/2022,OMN,FL,ASO,ES,Federal Contract Tower,0,0,2,0,2,0,0,47,0,47,0,0,49,0,49,26,0,26,75
10/17/2022,OMN,FL,ASO,ES,Federal Contract Tower,0,0,7,0,7,0,0,118,0,118,0,0,125,0,125,292,0,292,417
10/18/2022,OMN,FL,ASO,ES,Federal Contract Tower,0,0,13,0,13,0,0,140,0,140,0,0,153,0,153,224,0,224,377
10/19/2022,OMN,FL,ASO,ES,Federal Contract Tower,0,0,11,0,11,0,0,116,0,116,0,0,127,0,127,306,0,306,433
10/20/2022,OMN,FL,ASO,ES,Federal Contract Tower,0,0,10,0,10,0,0,190,0,190,0,0,200,0,200,340,0,340,540
10/21/2022,OMN,FL,ASO,ES,Federal Contract Tower,0,0,8,0,8,0,0,152,0,152,0,0,160,0,160,418,0,418,578
10/22/2022,OMN,FL,ASO,ES,Federal Contract Tower,0,0,12,0,12,0,0,71,0,71,0,0,83,0,83,112,0,112,195
10/23/2022,OMN,FL,ASO,ES,Federal Contract Tower,0,0,8,0,8,0,0,36,0,36,0,0,44,0,44,88,0,88,132
10/24/2022,OMN,FL,ASO,ES,Federal Contract Tower,0,0,16,0,16,0,0,83,0,83,0,0,99,0,99,304,0,304,403
10/25/2022,OMN,FL,ASO,ES,Federal Contract Tower,0,0,16,0,16,0,0,171,0,171,0,0,187,0,187,270,0,270,457
10/26/2022,OMN,FL,ASO,ES,Federal Contract Tower,0,0,9,0,9,0,0,128,0,128,0,0,137,0,137,256,0,256,393
10/27/2022,OMN,FL,ASO,ES,Federal Contract Tower,0,0,23,0,23,0,0,101,0,101,0,0,124,0,124,320,0,320,444
10/28/2022,OMN,FL,ASO,ES,Federal Contract Tower,0,0,21,0,21,0,0,31,0,31,0,0,52,0,52,24,0,24,76
10/29/2022,OMN,FL,ASO,ES,Federal Contract Tower,0,0,8,0,8,0,0,70,0,70,0,0,78,0,78,152,0,152,230
10/30/2022,OMN,FL,ASO,ES,Federal Contract Tower,0,0,8,0,8,0,0,15,0,15,0,0,23,0,23,4,0,4,27
10/31/2022,OMN,FL,ASO,ES,Federal Contract Tower,0,0,12,0,12,0,0,90,0,90,0,0,102,0,102,226,0,226,328
11/01/2022,OMN,FL,ASO,ES,Federal Contract Tower,0,0,26,0,26,0,0,129,0,129,0,0,155,0,155,238,0,238,393
11/02/2022,OMN,FL,ASO,ES,Federal Contract Tower,0,0,12,0,12,0,0,154,0,154,0,0,166,0,166,288,0,288,454
11/03/2022,OMN,FL,ASO,ES,Federal Contract Tower,0,0,16,0,16,0,0,126,0,126,0,0,142,0,142,310,0,310,452
11/04/2022,OMN,FL,ASO,ES,Federal Contract Tower,0,0,15,0,15,0,0,88,0,88,0,0,103,0,103,260,0,260,363
11/05/2022,OMN,FL,ASO,ES,Federal Contract Tower,0,0,11,0,11,0,0,56,0,56,0,0,67,0,67,80,0,80,147
11/06/2022,OMN,FL,ASO,ES,Federal Contract Tower,0,0,7,0,7,0,0,35,0,35,0,0,42,0,42,140,0,140,182
11/07/2022,OMN,FL,ASO,ES,Federal Contract Tower,0,0,6,0,6,0,0,69,0,69,0,0,75,0,75,164,0,164,239
11/08/2022,OMN,FL,ASO,ES,Federal Contract Tower,0,0,6,0,6,0,0,7,0,7,0,0,13,0,13,8,0,8,21
11/09/2022,OMN,FL,ASO,ES,Federal Contract Tower,0,0,0,0,0,0,0,0,0,0,0,0,0,0,0,0,0,0,0
11/11/2022,OMN,FL,ASO,ES,Federal Contract Tower,0,0,6,0,6,0,0,23,0,23,0,0,29,0,29,16,0,16,45
11/12/2022,OMN,FL,ASO,ES,Federal Contract Tower,0,0,15,0,15,0,0,106,0,106,0,0,121,0,121,194,0,194,315
11/13/2022,OMN,FL,ASO,ES,Federal Contract Tower,0,0,5,0,5,0,0,32,0,32,0,0,37,0,37,74,0,74,111
11/14/2022,OMN,FL,ASO,ES,Federal Contract Tower,0,0,14,0,14,0,0,158,0,158,0,0,172,0,172,254,0,254,426
11/15/2022,OMN,FL,ASO,ES,Federal Contract Tower,0,0,19,0,19,0,0,144,0,144,0,0,163,0,163,368,0,368,531
11/16/2022,OMN,FL,ASO,ES,Federal Contract Tower,0,0,22,0,22,0,0,16,0,16,0,0,38,0,38,30,0,30,68
11/17/2022,OMN,FL,ASO,ES,Federal Contract Tower,9,0,144,0,153,0,0,0,0,0,9,0,144,0,153,356,0,356,509
11/18/2022,OMN,FL,ASO,ES,Federal Contract Tower,0,0,16,0,16,0,0,188,0,188,0,0,204,0,204,400,0,400,604
11/19/2022,OMN,FL,ASO,ES,Federal Contract Tower,0,0,19,0,19,0,0,127,0,127,0,0,146,0,146,293,0,293,439
11/20/2022,OMN,FL,ASO,ES,Federal Contract Tower,0,0,6,0,6,0,0,25,0,25,0,0,31,0,31,76,0,76,107
11/21/2022,OMN,FL,ASO,ES,Federal Contract Tower,0,0,16,0,16,0,0,75,0,75,0,0,91,0,91,234,0,234,325
11/22/2022,OMN,FL,ASO,ES,Federal Contract Tower,0,0,7,0,7,0,0,0,0,0,0,0,7,0,7,0,0,0,7
11/23/2022,OMN,FL,ASO,ES,Federal Contract Tower,0,0,10,0,10,0,0,0,0,0,0,0,10,0,10,0,0,0,10
11/24/2022,OMN,FL,ASO,ES,Federal Contract Tower,0,0,0,0,0,0,0,2,0,2,0,0,2,0,2,0,0,0,2
11/25/2022,OMN,FL,ASO,ES,Federal Contract Tower,0,0,14,0,14,0,0,48,0,48,0,0,62,0,62,150,0,150,212
11/26/2022,OMN,FL,ASO,ES,Federal Contract Tower,0,0,32,0,32,0,0,29,0,29,0,0,61,0,61,64,0,64,125
11/27/2022,OMN,FL,ASO,ES,Federal Contract Tower,0,0,15,0,15,0,0,21,0,21,0,0,36,0,36,48,0,48,84
11/28/2022,OMN,FL,ASO,ES,Federal Contract Tower,0,0,10,0,10,0,0,161,0,161,0,0,171,0,171,302,0,302,473
11/29/2022,OMN,FL,ASO,ES,Federal Contract Tower,0,0,16,0,16,0,0,177,0,177,0,0,193,0,193,378,0,378,571
11/30/2022,OMN,FL,ASO,ES,Federal Contract Tower,0,0,4,0,4,0,0,151,0,151,0,0,155,0,155,222,0,222,377
12/01/2022,OMN,FL,ASO,ES,Federal Contract Tower,0,0,10,0,10,0,0,121,0,121,0,0,131,0,131,204,0,204,335
12/02/2022,OMN,FL,ASO,ES,Federal Contract Tower,0,0,14,0,14,0,0,133,0,133,0,0,147,0,147,380,0,380,527
12/03/2022,OMN,FL,ASO,ES,Federal Contract Tower,0,0,16,0,16,0,0,132,0,132,0,0,148,0,148,326,0,326,474
12/04/2022,OMN,FL,ASO,ES,Federal Contract Tower,0,0,8,0,8,0,0,46,0,46,0,0,54,0,54,162,0,162,216
12/05/2022,OMN,FL,ASO,ES,Federal Contract Tower,0,0,15,0,15,0,0,102,0,102,0,0,117,0,117,360,0,360,477
12/06/2022,OMN,FL,ASO,ES,Federal Contract Tower,0,0,20,0,20,0,0,205,0,205,0,0,225,0,225,356,0,356,581
12/07/2022,OMN,FL,ASO,ES,Federal Contract Tower,0,0,9,0,9,0,0,154,0,154,0,0,163,0,163,454,0,454,617
12/08/2022,OMN,FL,ASO,ES,Federal Contract Tower,0,0,22,0,22,0,0,159,0,159,0,0,181,0,181,348,0,348,529
12/09/2022,OMN,FL,ASO,ES,Federal Contract Tower,0,0,8,0,8,0,0,110,0,110,0,0,118,0,118,242,0,242,360
12/10/2022,OMN,FL,ASO,ES,Federal Contract Tower,0,0,9,0,9,0,0,25,0,25,0,0,34,0,34,48,0,48,82
12/11/2022,OMN,FL,ASO,ES,Federal Contract Tower,0,0,15,0,15,0,0,0,0,0,0,0,15,0,15,4,0,4,19
12/12/2022,OMN,FL,ASO,ES,Federal Contract Tower,0,0,17,0,17,0,0,97,0,97,0,0,114,0,114,376,0,376,490
12/13/2022,OMN,FL,ASO,ES,Federal Contract Tower,0,0,12,0,12,0,0,39,0,39,0,0,51,0,51,98,0,98,149
12/14/2022,OMN,FL,ASO,ES,Federal Contract Tower,0,0,16,0,16,0,0,171,0,171,0,0,187,0,187,308,0,308,495
12/15/2022,OMN,FL,ASO,ES,Federal Contract Tower,0,0,5,0,5,0,0,3,0,3,0,0,8,0,8,10,0,10,18
12/16/2022,OMN,FL,ASO,ES,Federal Contract Tower,0,0,15,0,15,0,0,156,0,156,0,0,171,0,171,306,0,306,477
12/17/2022,OMN,FL,ASO,ES,Federal Contract Tower,0,0,16,0,16,0,0,73,0,73,0,0,89,0,89,238,0,238,327
12/18/2022,OMN,FL,ASO,ES,Federal Contract Tower,0,0,4,0,4,0,0,63,0,63,0,0,67,0,67,177,0,177,244
12/19/2022,OMN,FL,ASO,ES,Federal Contract Tower,0,0,10,0,10,0,0,91,0,91,0,0,101,0,101,248,0,248,349
12/20/2022,OMN,FL,ASO,ES,Federal Contract Tower,0,0,4,0,4,0,0,47,0,47,0,0,51,0,51,124,0,124,175
12/21/2022,OMN,FL,ASO,ES,Federal Contract Tower,0,0,3,0,3,0,0,0,0,0,0,0,3,0,3,6,0,6,9
12/22/2022,OMN,FL,ASO,ES,Federal Contract Tower,0,0,9,0,9,0,0,22,0,22,0,0,31,0,31,55,0,55,86
12/23/2022,OMN,FL,ASO,ES,Federal Contract Tower,0,0,14,0,14,0,0,63,0,63,0,0,77,0,77,100,0,100,177
12/24/2022,OMN,FL,ASO,ES,Federal Contract Tower,0,0,2,0,2,0,0,36,0,36,0,0,38,0,38,96,0,96,134
12/25/2022,OMN,FL,ASO,ES,Federal Contract Tower,0,0,0,0,0,0,0,10,0,10,0,0,10,0,10,0,0,0,10
12/26/2022,OMN,FL,ASO,ES,Federal Contract Tower,0,0,2,0,2,0,0,39,0,39,0,0,41,0,41,4,0,4,45
12/27/2022,OMN,FL,ASO,ES,Federal Contract Tower,0,0,6,0,6,0,0,83,0,83,0,0,89,0,89,158,0,158,247
12/28/2022,OMN,FL,ASO,ES,Federal Contract Tower,0,0,9,0,9,0,0,118,0,118,0,0,127,0,127,164,0,164,291
12/29/2022,OMN,FL,ASO,ES,Federal Contract Tower,0,0,9,0,9,0,0,68,0,68,0,0,77,0,77,119,0,119,196
12/30/2022,OMN,FL,ASO,ES,Federal Contract Tower,0,0,7,0,7,0,0,54,0,54,0,0,61,0,61,70,0,70,131
12/31/2022,OMN,FL,ASO,ES,Federal Contract Tower,0,0,2,0,2,0,0,0,0,0,0,0,2,0,2,0,0,0,2
01/01/2023,OMN,FL,ASO,ES,Federal Contract Tower,0,0,1,0,1,0,0,13,0,13,0,0,14,0,14,8,0,8,22
01/02/2023,OMN,FL,ASO,ES,Federal Contract Tower,0,0,4,0,4,0,0,43,0,43,0,0,47,0,47,14,0,14,61
01/03/2023,OMN,FL,ASO,ES,Federal Contract Tower,0,0,17,0,17,0,0,31,0,31,0,0,48,0,48,132,0,132,180
01/04/2023,OMN,FL,ASO,ES,Federal Contract Tower,0,0,8,0,8,0,0,24,0,24,0,0,32,0,32,22,0,22,54
01/05/2023,OMN,FL,ASO,ES,Federal Contract Tower,0,0,4,0,4,0,0,30,0,30,0,0,34,0,34,94,0,94,128
01/06/2023,OMN,FL,ASO,ES,Federal Contract Tower,0,0,10,0,10,0,0,117,0,117,0,0,127,0,127,222,0,222,349
01/07/2023,OMN,FL,ASO,ES,Federal Contract Tower,0,0,12,0,12,0,0,117,0,117,0,0,129,0,129,264,0,264,393
01/08/2023,OMN,FL,ASO,ES,Federal Contract Tower,0,0,7,0,7,0,0,27,0,27,0,0,34,0,34,46,0,46,80
01/09/2023,OMN,FL,ASO,ES,Federal Contract Tower,0,0,11,0,11,0,0,108,0,108,0,0,119,0,119,290,0,290,409
01/10/2023,OMN,FL,ASO,ES,Federal Contract Tower,0,0,6,0,6,0,0,108,0,108,0,0,114,0,114,342,0,342,456
01/11/2023,OMN,FL,ASO,ES,Federal Contract Tower,0,0,14,0,14,0,0,169,0,169,0,0,183,0,183,306,0,306,489
01/12/2023,OMN,FL,ASO,ES,Federal Contract Tower,0,0,19,0,19,0,0,159,0,159,0,0,178,0,178,328,0,328,506
01/13/2023,OMN,FL,ASO,ES,Federal Contract Tower,0,0,9,0,9,0,0,2,0,2,0,0,11,0,11,4,0,4,15
01/14/2023,OMN,FL,ASO,ES,Federal Contract Tower,0,0,7,0,7,0,0,26,0,26,0,0,33,0,33,40,0,40,73
01/15/2023,OMN,FL,ASO,ES,Federal Contract Tower,0,0,7,0,7,0,0,44,0,44,0,0,51,0,51,148,0,148,199
01/16/2023,OMN,FL,ASO,ES,Federal Contract Tower,0,0,13,0,13,0,0,145,0,145,0,0,158,0,158,376,0,376,534
01/17/2023,OMN,FL,ASO,ES,Federal Contract Tower,0,0,6,0,6,0,0,107,0,107,0,0,113,0,113,272,0,272,385
01/18/2023,OMN,FL,ASO,ES,Federal Contract Tower,0,0,14,0,14,0,0,207,0,207,0,0,221,0,221,332,0,332,553
01/19/2023,OMN,FL,ASO,ES,Federal Contract Tower,0,0,7,0,7,0,0,107,0,107,0,0,114,0,114,228,0,228,342
01/20/2023,OMN,FL,ASO,ES,Federal Contract Tower,0,0,11,0,11,0,0,130,0,130,0,0,141,0,141,332,0,332,473
01/21/2023,OMN,FL,ASO,ES,Federal Contract Tower,0,0,14,0,14,0,0,111,0,111,0,0,125,0,125,228,0,228,353
01/22/2023,OMN,FL,ASO,ES,Federal Contract Tower,0,0,1,0,1,0,0,26,0,26,0,0,27,0,27,88,4,92,119
01/23/2023,OMN,FL,ASO,ES,Federal Contract Tower,0,0,6,0,6,0,0,72,0,72,0,0,78,0,78,326,0,326,404
01/24/2023,OMN,FL,ASO,ES,Federal Contract Tower,0,0,12,1,13,0,0,150,0,150,0,0,162,1,163,306,0,306,469
01/25/2023,OMN,FL,ASO,ES,Federal Contract Tower,0,0,2,0,2,0,0,92,0,92,0,0,94,0,94,122,0,122,216
01/26/2023,OMN,FL,ASO,ES,Federal Contract Tower,0,0,14,0,14,0,0,165,0,165,0,0,179,0,179,416,0,416,595
01/27/2023,OMN,FL,ASO,ES,Federal Contract Tower,0,0,22,0,22,0,0,143,0,143,0,0,165,0,165,312,0,312,477
01/28/2023,OMN,FL,ASO,ES,Federal Contract Tower,0,0,14,0,14,0,0,91,2,93,0,0,105,2,107,100,0,100,207
01/29/2023,OMN,FL,ASO,ES,Federal Contract Tower,0,0,7,0,7,0,0,80,0,80,0,0,87,0,87,190,0,190,277
01/30/2023,OMN,FL,ASO,ES,Federal Contract Tower,0,0,13,0,13,0,0,112,0,112,0,0,125,0,125,294,0,294,419
01/31/2023,OMN,FL,ASO,ES,Federal Contract Tower,0,0,19,0,19,0,0,110,0,110,0,0,129,0,129,272,0,272,401
02/01/2023,OMN,FL,ASO,ES,Federal Contract Tower,0,0,14,0,14,0,0,154,0,154,0,0,168,0,168,344,0,344,512
02/02/2023,OMN,FL,ASO,ES,Federal Contract Tower,0,0,18,0,18,0,0,168,0,168,0,0,186,0,186,386,0,386,572
02/03/2023,OMN,FL,ASO,ES,Federal Contract Tower,0,0,5,0,5,0,0,4,0,4,0,0,9,0,9,0,0,0,9
02/04/2023,OMN,FL,ASO,ES,Federal Contract Tower,0,0,14,0,14,0,0,62,0,62,0,0,76,0,76,76,0,76,152
02/05/2023,OMN,FL,ASO,ES,Federal Contract Tower,0,0,10,0,10,0,0,22,0,22,0,0,32,0,32,80,0,80,112
02/06/2023,OMN,FL,ASO,ES,Federal Contract Tower,0,0,12,0,12,0,0,156,0,156,0,0,168,0,168,348,0,348,516
02/07/2023,OMN,FL,ASO,ES,Federal Contract Tower,0,0,10,0,10,0,0,137,0,137,0,0,147,0,147,314,0,314,461
02/08/2023,OMN,FL,ASO,ES,Federal Contract Tower,0,0,16,0,16,0,0,169,0,169,0,0,185,0,185,308,0,308,493
02/09/2023,OMN,FL,ASO,ES,Federal Contract Tower,0,0,19,0,19,0,0,115,0,115,0,0,134,0,134,348,0,348,482
02/10/2023,OMN,FL,ASO,ES,Federal Contract Tower,0,0,13,0,13,0,0,145,0,145,0,0,158,0,158,180,0,180,338
02/11/2023,OMN,FL,ASO,ES,Federal Contract Tower,0,0,12,0,12,0,0,11,0,11,0,0,23,0,23,12,0,12,35
02/12/2023,OMN,FL,ASO,ES,Federal Contract Tower,0,0,2,0,2,0,0,3,0,3,0,0,5,0,5,2,0,2,7
02/13/2023,OMN,FL,ASO,ES,Federal Contract Tower,0,0,11,0,11,0,0,167,0,167,0,0,178,0,178,404,0,404,582
02/14/2023,OMN,FL,ASO,ES,Federal Contract Tower,0,0,15,0,15,0,0,163,0,163,0,0,178,0,178,400,0,400,578
02/15/2023,OMN,FL,ASO,ES,Federal Contract Tower,0,0,14,0,14,0,0,128,0,128,0,0,142,0,142,218,0,218,360
02/16/2023,OMN,FL,ASO,ES,Federal Contract Tower,0,0,17,0,17,0,0,126,0,126,0,0,143,0,143,368,0,368,511
02/17/2023,OMN,FL,ASO,ES,Federal Contract Tower,0,0,16,0,16,0,0,61,0,61,0,0,77,0,77,46,0,46,123
02/18/2023,OMN,FL,ASO,ES,Federal Contract Tower,0,0,4,0,4,0,0,85,0,85,0,0,89,0,89,46,0,46,135
02/19/2023,OMN,FL,ASO,ES,Federal Contract Tower,0,0,11,0,11,0,0,56,0,56,0,0,67,0,67,100,0,100,167
02/20/2023,OMN,FL,ASO,ES,Federal Contract Tower,0,0,10,0,10,0,0,128,0,128,0,0,138,0,138,362,0,362,500
02/21/2023,OMN,FL,ASO,ES,Federal Contract Tower,0,0,19,0,19,0,0,103,0,103,0,0,122,0,122,202,0,202,324
02/22/2023,OMN,FL,ASO,ES,Federal Contract Tower,0,0,8,0,8,0,0,145,0,145,0,0,153,0,153,282,0,282,435
02/23/2023,OMN,FL,ASO,ES,Federal Contract Tower,0,0,19,0,19,0,0,138,0,138,0,0,157,0,157,334,0,334,491
02/24/2023,OMN,FL,ASO,ES,Federal Contract Tower,0,0,19,0,19,0,0,109,0,109,0,0,128,0,128,308,0,308,436
02/25/2023,OMN,FL,ASO,ES,Federal Contract Tower,0,0,19,0,19,0,0,102,0,102,0,0,121,0,121,244,0,244,365
02/26/2023,OMN,FL,ASO,ES,Federal Contract Tower,0,0,11,0,11,0,0,79,0,79,0,0,90,0,90,192,0,192,282
02/27/2023,OMN,FL,ASO,ES,Federal Contract Tower,0,0,10,0,10,0,0,98,0,98,0,0,108,0,108,188,0,188,296
02/28/2023,OMN,FL,ASO,ES,Federal Contract Tower,0,0,7,0,7,0,0,51,0,51,0,0,58,0,58,122,0,122,180
03/01/2023,OMN,FL,ASO,ES,Federal Contract Tower,0,0,8,0,8,0,0,176,0,176,0,0,184,0,184,198,0,198,382
03/02/2023,OMN,FL,ASO,ES,Federal Contract Tower,0,0,21,0,21,0,0,153,0,153,0,0,174,0,174,280,0,280,454
03/03/2023,OMN,FL,ASO,ES,Federal Contract Tower,0,0,8,0,8,0,0,95,0,95,0,0,103,0,103,124,0,124,227
03/04/2023,OMN,FL,ASO,ES,Federal Contract Tower,0,0,7,0,7,0,0,82,0,82,0,0,89,0,89,80,0,80,169
03/05/2023,OMN,FL,ASO,ES,Federal Contract Tower,0,0,13,0,13,0,0,73,0,73,0,0,86,0,86,80,0,80,166
03/06/2023,OMN,FL,ASO,ES,Federal Contract Tower,0,0,12,0,12,0,0,123,0,123,0,0,135,0,135,360,0,360,495
03/07/2023,OMN,FL,ASO,ES,Federal Contract Tower,0,0,14,0,14,0,0,128,0,128,0,0,142,0,142,366,0,366,508
03/08/2023,OMN,FL,ASO,ES,Federal Contract Tower,0,0,7,0,7,0,0,28,0,28,0,0,35,0,35,86,0,86,121
03/09/2023,OMN,FL,ASO,ES,Federal Contract Tower,0,0,15,0,15,0,0,195,0,195,0,0,210,0,210,348,0,348,558
03/10/2023,OMN,FL,ASO,ES,Federal Contract Tower,0,0,11,0,11,0,0,102,0,102,0,0,113,0,113,196,0,196,309
03/11/2023,OMN,FL,ASO,ES,Federal Contract Tower,0,0,12,0,12,0,0,121,0,121,0,0,133,0,133,200,0,200,333
03/12/2023,OMN,FL,ASO,ES,Federal Contract Tower,0,0,11,0,11,0,0,56,0,56,0,0,67,0,67,70,0,70,137
03/13/2023,OMN,FL,ASO,ES,Federal Contract Tower,0,0,10,0,10,0,0,6,0,6,0,0,16,0,16,0,0,0,16
03/14/2023,OMN,FL,ASO,ES,Federal Contract Tower,0,0,28,0,28,0,0,180,0,180,0,0,208,0,208,454,0,454,662
03/15/2023,OMN,FL,ASO,ES,Federal Contract Tower,0,0,13,0,13,0,0,132,0,132,0,0,145,0,145,338,0,338,483
03/16/2023,OMN,FL,ASO,ES,Federal Contract Tower,0,0,6,0,6,0,0,124,0,124,0,0,130,0,130,412,0,412,542
03/17/2023,OMN,FL,ASO,ES,Federal Contract Tower,0,0,14,0,14,0,0,130,0,130,0,0,144,0,144,240,0,240,384
03/18/2023,OMN,FL,ASO,ES,Federal Contract Tower,0,0,2,0,2,0,0,50,0,50,0,0,52,0,52,72,0,72,124
03/19/2023,OMN,FL,ASO,ES,Federal Contract Tower,0,0,6,0,6,0,0,21,0,21,0,0,27,0,27,48,0,48,75
03/20/2023,OMN,FL,ASO,ES,Federal Contract Tower,0,0,10,0,10,0,0,138,0,138,0,0,148,0,148,382,0,382,530
03/21/2023,OMN,FL,ASO,ES,Federal Contract Tower,0,0,10,0,10,0,0,89,0,89,0,0,99,0,99,220,0,220,319
03/22/2023,OMN,FL,ASO,ES,Federal Contract Tower,0,0,15,0,15,0,0,117,0,117,0,0,132,0,132,280,0,280,412
03/23/2023,OMN,FL,ASO,ES,Federal Contract Tower,0,0,17,0,17,0,0,185,0,185,0,0,202,0,202,436,0,436,638
03/24/2023,OMN,FL,ASO,ES,Federal Contract Tower,0,0,10,0,10,0,0,133,0,133,0,0,143,0,143,464,0,464,607
03/25/2023,OMN,FL,ASO,ES,Federal Contract Tower,0,0,15,0,15,0,0,54,0,54,0,0,69,0,69,94,0,94,163
03/26/2023,OMN,FL,ASO,ES,Federal Contract Tower,0,0,10,0,10,0,0,37,0,37,0,0,47,0,47,148,0,148,195
03/27/2023,OMN,FL,ASO,ES,Federal Contract Tower,0,0,9,0,9,0,0,189,0,189,0,0,198,0,198,284,0,284,482
03/28/2023,OMN,FL,ASO,ES,Federal Contract Tower,0,0,13,0,13,0,0,100,0,100,0,0,113,0,113,142,0,142,255
03/29/2023,OMN,FL,ASO,ES,Federal Contract Tower,0,0,13,0,13,0,0,75,0,75,0,0,88,0,88,172,0,172,260
03/30/2023,OMN,FL,ASO,ES,Federal Contract Tower,0,0,10,0,10,0,0,139,0,139,0,0,149,0,149,320,0,320,469
03/31/2023,OMN,FL,ASO,ES,Federal Contract Tower,0,0,14,0,14,0,0,106,0,106,0,0,120,0,120,212,0,212,332
04/01/2023,OMN,FL,ASO,ES,Federal Contract Tower,0,0,8,0,8,0,0,101,0,101,0,0,109,0,109,162,0,162,271
04/02/2023,OMN,FL,ASO,ES,Federal Contract Tower,0,0,14,0,14,0,0,29,0,29,0,0,43,0,43,122,0,122,165
04/03/2023,OMN,FL,ASO,ES,Federal Contract Tower,0,0,13,0,13,0,0,87,0,87,0,0,100,0,100,230,0,230,330
04/04/2023,OMN,FL,ASO,ES,Federal Contract Tower,0,0,18,0,18,0,0,204,0,204,0,0,222,0,222,386,0,386,608
04/05/2023,OMN,FL,ASO,ES,Federal Contract Tower,0,0,7,0,7,0,0,115,0,115,0,0,122,0,122,216,0,216,338
04/06/2023,OMN,FL,ASO,ES,Federal Contract Tower,0,0,16,0,16,0,0,133,0,133,0,0,149,0,149,400,0,400,549
04/07/2023,OMN,FL,ASO,ES,Federal Contract Tower,0,0,18,0,18,0,0,136,0,136,0,0,154,0,154,400,0,400,554
04/08/2023,OMN,FL,ASO,ES,Federal Contract Tower,0,0,11,0,11,0,0,133,0,133,0,0,144,0,144,222,0,222,366
04/09/2023,OMN,FL,ASO,ES,Federal Contract Tower,0,0,2,0,2,0,0,0,0,0,0,0,2,0,2,0,0,0,2
04/10/2023,OMN,FL,ASO,ES,Federal Contract Tower,0,0,4,0,4,0,0,2,0,2,0,0,6,0,6,0,0,0,6
04/11/2023,OMN,FL,ASO,ES,Federal Contract Tower,0,0,9,0,9,0,0,26,0,26,0,0,35,0,35,44,0,44,79
04/12/2023,OMN,FL,ASO,ES,Federal Contract Tower,0,0,12,0,12,0,0,90,0,90,0,0,102,0,102,114,0,114,216
04/13/2023,OMN,FL,ASO,ES,Federal Contract Tower,0,0,7,0,7,0,0,35,0,35,0,0,42,0,42,112,0,112,154
04/14/2023,OMN,FL,ASO,ES,Federal Contract Tower,0,0,7,0,7,0,0,98,0,98,0,0,105,0,105,268,0,268,373
04/15/2023,OMN,FL,ASO,ES,Federal Contract Tower,0,0,10,0,10,0,0,173,0,173,0,0,183,0,183,368,0,368,551
04/16/2023,OMN,FL,ASO,ES,Federal Contract Tower,0,0,9,0,9,0,0,48,0,48,0,0,57,0,57,180,0,180,237
04/17/2023,OMN,FL,ASO,ES,Federal Contract Tower,0,0,15,0,15,0,0,88,0,88,0,0,103,0,103,324,0,324,427
04/18/2023,OMN,FL,ASO,ES,Federal Contract Tower,0,0,17,0,17,0,0,195,0,195,0,0,212,0,212,472,0,472,684
04/19/2023,OMN,FL,ASO,ES,Federal Contract Tower,0,0,10,0,10,0,0,144,0,144,0,0,154,0,154,398,0,398,552
04/20/2023,OMN,FL,ASO,ES,Federal Contract Tower,0,0,18,0,18,0,0,147,0,147,0,0,165,0,165,232,0,232,397
04/21/2023,OMN,FL,ASO,ES,Federal Contract Tower,0,0,11,0,11,0,0,114,0,114,0,0,125,0,125,248,0,248,373
04/22/2023,OMN,FL,ASO,ES,Federal Contract Tower,0,0,6,0,6,0,0,98,0,98,0,0,104,0,104,172,0,172,276
04/23/2023,OMN,FL,ASO,ES,Federal Contract Tower,0,0,10,0,10,0,0,22,0,22,0,0,32,0,32,82,0,82,114
04/24/2023,OMN,FL,ASO,ES,Federal Contract Tower,0,0,9,0,9,0,0,108,0,108,0,0,117,0,117,265,0,265,382
04/25/2023,OMN,FL,ASO,ES,Federal Contract Tower,0,0,17,0,17,0,0,125,0,125,0,0,142,0,142,216,0,216,358
04/26/2023,OMN,FL,ASO,ES,Federal Contract Tower,0,0,7,0,7,0,0,101,0,101,0,0,108,0,108,336,0,336,444
04/27/2023,OMN,FL,ASO,ES,Federal Contract Tower,0,0,13,0,13,0,0,63,0,63,0,0,76,0,76,194,0,194,270
04/28/2023,OMN,FL,ASO,ES,Federal Contract Tower,0,0,16,0,16,0,0,107,0,107,0,0,123,0,123,190,0,190,313
04/29/2023,OMN,FL,ASO,ES,Federal Contract Tower,0,0,20,0,20,0,0,148,0,148,0,0,168,0,168,232,0,232,400
04/30/2023,OMN,FL,ASO,ES,Federal Contract Tower,0,0,6,0,6,0,0,1,0,1,0,0,7,0,7,0,0,0,7
05/01/2023,OMN,FL,ASO,ES,Federal Contract Tower,0,0,7,0,7,0,0,107,0,107,0,0,114,0,114,204,0,204,318
05/02/2023,OMN,FL,ASO,ES,Federal Contract Tower,0,0,10,0,10,0,0,126,0,126,0,0,136,0,136,224,0,224,360
05/03/2023,OMN,FL,ASO,ES,Federal Contract Tower,0,0,9,0,9,0,0,64,0,64,0,0,73,0,73,192,0,192,265
05/04/2023,OMN,FL,ASO,ES,Federal Contract Tower,0,0,19,0,19,0,0,133,0,133,0,0,152,0,152,390,0,390,542
05/05/2023,OMN,FL,ASO,ES,Federal Contract Tower,0,0,11,0,11,0,0,138,0,138,0,0,149,0,149,399,0,399,548
05/06/2023,OMN,FL,ASO,ES,Federal Contract Tower,0,0,10,0,10,0,0,25,0,25,0,0,35,0,35,74,0,74,109
05/07/2023,OMN,FL,ASO,ES,Federal Contract Tower,0,0,6,0,6,0,0,59,0,59,0,0,65,0,65,130,0,130,195
05/08/2023,OMN,FL,ASO,ES,Federal Contract Tower,0,0,12,0,12,0,0,133,0,133,0,0,145,0,145,234,0,234,379
05/09/2023,OMN,FL,ASO,ES,Federal Contract Tower,0,0,11,0,11,0,0,121,0,121,0,0,132,0,132,284,0,284,416
05/10/2023,OMN,FL,ASO,ES,Federal Contract Tower,0,0,8,0,8,0,0,103,0,103,0,0,111,0,111,96,0,96,207
05/11/2023,OMN,FL,ASO,ES,Federal Contract Tower,0,0,14,0,14,0,0,102,0,102,0,0,116,0,116,214,0,214,330
05/12/2023,OMN,FL,ASO,ES,Federal Contract Tower,0,0,14,0,14,0,0,111,0,111,0,0,125,0,125,0,0,0,125
05/13/2023,OMN,FL,ASO,ES,Federal Contract Tower,0,0,9,0,9,0,0,98,0,98,0,0,107,0,107,164,0,164,271
05/14/2023,OMN,FL,ASO,ES,Federal Contract Tower,0,0,12,0,12,0,0,76,0,76,0,0,88,0,88,146,0,146,234
05/15/2023,OMN,FL,ASO,ES,Federal Contract Tower,0,0,15,0,15,0,0,136,0,136,0,0,151,0,151,0,0,0,151
05/16/2023,OMN,FL,ASO,ES,Federal Contract Tower,0,0,19,0,19,0,0,98,0,98,0,0,117,0,117,242,0,242,359
05/17/2023,OMN,FL,ASO,ES,Federal Contract Tower,0,0,10,0,10,0,0,117,0,117,0,0,127,0,127,260,2,262,389
05/18/2023,OMN,FL,ASO,ES,Federal Contract Tower,0,0,9,0,9,0,0,86,0,86,0,0,95,0,95,258,0,258,353
05/19/2023,OMN,FL,ASO,ES,Federal Contract Tower,0,0,16,0,16,0,0,70,0,70,0,0,86,0,86,164,0,164,250
05/20/2023,OMN,FL,ASO,ES,Federal Contract Tower,0,0,16,0,16,0,0,50,0,50,0,0,66,0,66,124,0,124,190
05/21/2023,OMN,FL,ASO,ES,Federal Contract Tower,0,0,8,0,8,0,0,41,0,41,0,0,49,0,49,33,0,33,82
05/22/2023,OMN,FL,ASO,ES,Federal Contract Tower,0,0,3,0,3,0,0,38,0,38,0,0,41,0,41,74,0,74,115
05/23/2023,OMN,FL,ASO,ES,Federal Contract Tower,0,0,8,0,8,0,0,79,0,79,0,0,87,0,87,146,0,146,233
05/24/2023,OMN,FL,ASO,ES,Federal Contract Tower,0,0,7,0,7,0,0,14,0,14,0,0,21,0,21,24,0,24,45
05/25/2023,OMN,FL,ASO,ES,Federal Contract Tower,0,0,8,0,8,0,0,63,0,63,0,0,71,0,71,136,0,136,207
05/26/2023,OMN,FL,ASO,ES,Federal Contract Tower,0,0,4,0,4,0,0,8,0,8,0,0,12,0,12,94,0,94,106
05/27/2023,OMN,FL,ASO,ES,Federal Contract Tower,0,0,15,0,15,0,0,131,0,131,0,0,146,0,146,224,0,224,370
05/28/2023,OMN,FL,ASO,ES,Federal Contract Tower,0,0,6,0,6,0,0,100,0,100,0,0,106,0,106,262,0,262,368
05/29/2023,OMN,FL,ASO,ES,Federal Contract Tower,0,0,13,0,13,0,0,133,0,133,0,0,146,0,146,262,0,262,408
05/30/2023,OMN,FL,ASO,ES,Federal Contract Tower,0,0,7,0,7,0,0,142,0,142,0,0,149,0,149,262,0,262,411
05/31/2023,OMN,FL,ASO,ES,Federal Contract Tower,0,0,13,0,13,0,0,133,0,133,0,0,146,0,146,236,0,236,382
06/01/2023,OMN,FL,ASO,ES,Federal Contract Tower,0,0,15,0,15,0,0,137,0,137,0,0,152,0,152,244,0,244,396
06/02/2023,OMN,FL,ASO,ES,Federal Contract Tower,0,0,12,0,12,0,0,43,0,43,0,0,55,0,55,68,0,68,123
06/03/2023,OMN,FL,ASO,ES,Federal Contract Tower,0,0,7,0,7,0,0,67,0,67,0,0,74,0,74,136,0,136,210
06/04/2023,OMN,FL,ASO,ES,Federal Contract Tower,0,0,2,0,2,0,0,63,0,63,0,0,65,0,65,144,0,144,209
06/05/2023,OMN,FL,ASO,ES,Federal Contract Tower,0,0,11,0,11,0,0,39,0,39,0,0,50,0,50,104,0,104,154
06/06/2023,OMN,FL,ASO,ES,Federal Contract Tower,0,0,16,0,16,0,0,171,0,171,0,0,187,0,187,314,0,314,501
06/07/2023,OMN,FL,ASO,ES,Federal Contract Tower,0,0,8,0,8,0,0,111,0,111,0,0,119,0,119,176,0,176,295
06/08/2023,OMN,FL,ASO,ES,Federal Contract Tower,0,0,11,0,11,0,0,173,0,173,0,0,184,0,184,334,0,334,518
06/09/2023,OMN,FL,ASO,ES,Federal Contract Tower,0,0,7,0,7,0,0,142,0,142,0,0,149,0,149,270,0,270,419
06/10/2023,OMN,FL,ASO,ES,Federal Contract Tower,0,0,13,0,13,0,0,88,0,88,0,0,101,0,101,102,0,102,203
06/11/2023,OMN,FL,ASO,ES,Federal Contract Tower,0,0,7,0,7,0,0,65,0,65,0,0,72,0,72,148,0,148,220
06/12/2023,OMN,FL,ASO,ES,Federal Contract Tower,0,0,17,0,17,0,0,141,0,141,0,0,158,0,158,318,0,318,476
06/13/2023,OMN,FL,ASO,ES,Federal Contract Tower,0,0,11,0,11,0,0,130,0,130,0,0,141,0,141,374,0,374,515
06/14/2023,OMN,FL,ASO,ES,Federal Contract Tower,0,0,10,0,10,0,0,172,0,172,0,0,182,0,182,264,0,264,446
06/15/2023,OMN,FL,ASO,ES,Federal Contract Tower,0,0,7,0,7,0,0,104,0,104,0,0,111,0,111,140,0,140,251
06/16/2023,OMN,FL,ASO,ES,Federal Contract Tower,0,0,5,0,5,0,0,24,0,24,0,0,29,0,29,16,0,16,45
06/17/2023,OMN,FL,ASO,ES,Federal Contract Tower,0,0,9,0,9,0,0,71,0,71,0,0,80,0,80,122,0,122,202
06/18/2023,OMN,FL,ASO,ES,Federal Contract Tower,0,0,7,0,7,0,0,29,0,29,0,0,36,0,36,82,0,82,118
06/19/2023,OMN,FL,ASO,ES,Federal Contract Tower,0,0,16,0,16,0,0,118,0,118,0,0,134,0,134,282,0,282,416
06/20/2023,OMN,FL,ASO,ES,Federal Contract Tower,0,0,2,0,2,0,0,12,0,12,0,0,14,0,14,6,0,6,20
06/21/2023,OMN,FL,ASO,ES,Federal Contract Tower,0,0,9,0,9,0,0,78,0,78,0,0,87,0,87,82,0,82,169
06/22/2023,OMN,FL,ASO,ES,Federal Contract Tower,0,0,12,0,12,0,0,113,0,113,0,0,125,0,125,254,0,254,379
06/23/2023,OMN,FL,ASO,ES,Federal Contract Tower,0,0,9,0,9,0,0,53,0,53,0,0,62,0,62,116,0,116,178
06/24/2023,OMN,FL,ASO,ES,Federal Contract Tower,0,0,13,0,13,0,0,106,0,106,0,0,119,0,119,178,0,178,297
06/25/2023,OMN,FL,ASO,ES,Federal Contract Tower,0,0,10,0,10,0,0,73,0,73,0,0,83,0,83,66,0,66,149
06/26/2023,OMN,FL,ASO,ES,Federal Contract Tower,0,0,11,0,11,0,0,166,0,166,0,0,177,0,177,240,0,240,417
06/27/2023,OMN,FL,ASO,ES,Federal Contract Tower,0,0,9,0,9,0,0,134,0,134,0,0,143,0,143,296,0,296,439
06/28/2023,OMN,FL,ASO,ES,Federal Contract Tower,0,0,10,0,10,0,0,112,0,112,0,0,122,0,122,186,0,186,308
06/29/2023,OMN,FL,ASO,ES,Federal Contract Tower,0,0,8,0,8,0,0,174,0,174,0,0,182,0,182,238,0,238,420
06/30/2023,OMN,FL,ASO,ES,Federal Contract Tower,0,0,14,0,14,0,0,106,0,106,0,0,120,0,120,138,0,138,258
07/01/2023,OMN,FL,ASO,ES,Federal Contract Tower,0,0,4,0,4,0,0,119,0,119,0,0,123,0,123,162,0,162,285
07/02/2023,OMN,FL,ASO,ES,Federal Contract Tower,0,0,5,0,5,0,0,51,0,51,0,0,56,0,56,80,0,80,136
07/03/2023,OMN,FL,ASO,ES,Federal Contract Tower,0,0,9,0,9,0,0,102,0,102,0,0,111,0,111,306,0,306,417
07/04/2023,OMN,FL,ASO,ES,Federal Contract Tower,0,0,0,0,0,0,0,32,0,32,0,0,32,0,32,84,0,84,116
07/05/2023,OMN,FL,ASO,ES,Federal Contract Tower,0,0,9,0,9,0,0,67,0,67,0,0,76,0,76,140,0,140,216
07/06/2023,OMN,FL,ASO,ES,Federal Contract Tower,0,0,8,0,8,0,0,78,0,78,0,0,86,0,86,246,0,246,332
07/07/2023,OMN,FL,ASO,ES,Federal Contract Tower,0,0,6,0,6,0,0,70,0,70,0,0,76,0,76,220,0,220,296
07/08/2023,OMN,FL,ASO,ES,Federal Contract Tower,0,0,12,0,12,0,0,62,0,62,0,0,74,0,74,58,0,58,132
07/09/2023,OMN,FL,ASO,ES,Federal Contract Tower,0,0,4,0,4,0,0,38,0,38,0,0,42,0,42,136,0,136,178
07/10/2023,OMN,FL,ASO,ES,Federal Contract Tower,0,0,5,0,5,0,0,67,0,67,0,0,72,0,72,220,0,220,292
07/11/2023,OMN,FL,ASO,ES,Federal Contract Tower,0,0,7,0,7,0,0,56,0,56,0,0,63,0,63,112,0,112,175
07/12/2023,OMN,FL,ASO,ES,Federal Contract Tower,0,0,7,0,7,0,0,124,0,124,0,0,131,0,131,270,0,270,401
07/13/2023,OMN,FL,ASO,ES,Federal Contract Tower,0,0,17,0,17,0,0,123,0,123,0,0,140,0,140,348,0,348,488
07/14/2023,OMN,FL,ASO,ES,Federal Contract Tower,0,0,6,0,6,0,0,92,0,92,0,0,98,0,98,320,0,320,418
07/15/2023,OMN,FL,ASO,ES,Federal Contract Tower,0,0,21,0,21,0,0,103,0,103,0,0,124,0,124,282,0,282,406
07/16/2023,OMN,FL,ASO,ES,Federal Contract Tower,0,0,7,0,7,0,0,17,0,17,0,0,24,0,24,86,0,86,110
07/17/2023,OMN,FL,ASO,ES,Federal Contract Tower,0,0,10,0,10,0,0,57,0,57,0,0,67,0,67,142,0,142,209
07/18/2023,OMN,FL,ASO,ES,Federal Contract Tower,0,0,13,0,13,0,0,92,0,92,0,0,105,0,105,198,0,198,303
07/19/2023,OMN,FL,ASO,ES,Federal Contract Tower,0,0,19,0,19,0,0,128,0,128,0,0,147,0,147,266,0,266,413
07/20/2023,OMN,FL,ASO,ES,Federal Contract Tower,0,0,19,0,19,0,0,121,0,121,0,0,140,0,140,310,0,310,450
07/21/2023,OMN,FL,ASO,ES,Federal Contract Tower,0,0,16,0,16,0,0,135,0,135,0,0,151,0,151,270,0,270,421
07/22/2023,OMN,FL,ASO,ES,Federal Contract Tower,0,0,6,0,6,0,0,98,0,98,0,0,104,0,104,124,0,124,228
07/23/2023,OMN,FL,ASO,ES,Federal Contract Tower,0,0,9,0,9,0,0,37,0,37,0,0,46,0,46,83,0,83,129
07/24/2023,OMN,FL,ASO,ES,Federal Contract Tower,0,0,8,0,8,0,0,96,0,96,0,0,104,0,104,202,0,202,306
07/25/2023,OMN,FL,ASO,ES,Federal Contract Tower,0,0,17,0,17,0,0,107,0,107,0,0,124,0,124,226,0,226,350
07/26/2023,OMN,FL,ASO,ES,Federal Contract Tower,0,0,15,0,15,0,0,140,0,140,0,0,155,0,155,238,0,238,393
07/27/2023,OMN,FL,ASO,ES,Federal Contract Tower,0,0,11,0,11,0,0,54,0,54,0,0,65,0,65,122,0,122,187
07/28/2023,OMN,FL,ASO,ES,Federal Contract Tower,0,0,14,0,14,0,0,36,0,36,0,0,50,0,50,74,0,74,124
07/29/2023,OMN,FL,ASO,ES,Federal Contract Tower,0,0,17,0,17,0,0,78,0,78,0,0,95,0,95,194,0,194,289
07/30/2023,OMN,FL,ASO,ES,Federal Contract Tower,0,0,5,0,5,0,0,57,0,57,0,0,62,0,62,108,0,108,170
07/31/2023,OMN,FL,ASO,ES,Federal Contract Tower,0,0,10,0,10,0,0,135,0,135,0,0,145,0,145,210,0,210,355
08/01/2023,OMN,FL,ASO,ES,Federal Contract Tower,0,0,12,0,12,0,0,133,0,133,0,0,145,0,145,196,0,196,341
08/02/2023,OMN,FL,ASO,ES,Federal Contract Tower,0,0,8,0,8,0,0,131,0,131,0,0,139,0,139,218,0,218,357
08/03/2023,OMN,FL,ASO,ES,Federal Contract Tower,0,0,7,0,7,0,0,145,0,145,0,0,152,0,152,338,0,338,490
08/04/2023,OMN,FL,ASO,ES,Federal Contract Tower,0,0,6,0,6,0,0,144,0,144,0,0,150,0,150,178,0,178,328
08/05/2023,OMN,FL,ASO,ES,Federal Contract Tower,0,0,9,0,9,0,0,112,0,112,0,0,121,0,121,196,0,196,317
08/06/2023,OMN,FL,ASO,ES,Federal Contract Tower,0,0,7,0,7,0,0,46,0,46,0,0,53,0,53,132,0,132,185
08/07/2023,OMN,FL,ASO,ES,Federal Contract Tower,0,0,5,0,5,0,0,175,0,175,0,0,180,0,180,306,0,306,486
08/08/2023,OMN,FL,ASO,ES,Federal Contract Tower,0,0,9,0,9,0,0,116,0,116,0,0,125,0,125,222,0,222,347
08/09/2023,OMN,FL,ASO,ES,Federal Contract Tower,0,0,9,0,9,0,0,137,0,137,0,0,146,0,146,192,0,192,338
08/10/2023,OMN,FL,ASO,ES,Federal Contract Tower,0,0,13,0,13,0,0,157,0,157,0,0,170,0,170,346,0,346,516
08/11/2023,OMN,FL,ASO,ES,Federal Contract Tower,0,0,8,0,8,0,0,105,0,105,0,0,113,0,113,352,0,352,465
08/12/2023,OMN,FL,ASO,ES,Federal Contract Tower,0,0,6,0,6,0,0,68,0,68,0,0,74,0,74,150,0,150,224
08/13/2023,OMN,FL,ASO,ES,Federal Contract Tower,0,0,6,0,6,0,0,30,0,30,0,0,36,0,36,38,0,38,74
08/14/2023,OMN,FL,ASO,ES,Federal Contract Tower,0,0,5,0,5,0,0,80,0,80,0,0,85,0,85,204,0,204,289
08/15/2023,OMN,FL,ASO,ES,Federal Contract Tower,0,0,6,0,6,0,0,95,0,95,0,0,101,0,101,248,0,248,349
08/16/2023,OMN,FL,ASO,ES,Federal Contract Tower,0,0,10,0,10,0,0,98,0,98,0,0,108,0,108,248,0,248,356
08/18/2023,OMN,FL,ASO,ES,Federal Contract Tower,0,0,11,0,11,0,0,108,0,108,0,0,119,0,119,104,0,104,223
08/19/2023,OMN,FL,ASO,ES,Federal Contract Tower,0,0,9,0,9,0,0,125,0,125,0,0,134,0,134,142,0,142,276
08/20/2023,OMN,FL,ASO,ES,Federal Contract Tower,0,0,8,0,8,0,0,41,0,41,0,0,49,0,49,44,0,44,93
08/21/2023,OMN,FL,ASO,ES,Federal Contract Tower,0,0,13,0,13,0,0,100,0,100,0,0,113,0,113,214,0,214,327
08/22/2023,OMN,FL,ASO,ES,Federal Contract Tower,0,0,11,0,11,0,0,149,0,149,0,0,160,0,160,274,0,274,434
08/23/2023,OMN,FL,ASO,ES,Federal Contract Tower,0,0,15,0,15,0,0,169,0,169,0,0,184,0,184,258,0,258,442
08/24/2023,OMN,FL,ASO,ES,Federal Contract Tower,0,0,16,0,16,0,0,145,0,145,0,0,161,0,161,230,0,230,391
08/25/2023,OMN,FL,ASO,ES,Federal Contract Tower,0,0,12,0,12,0,0,89,0,89,0,0,101,0,101,238,0,238,339
08/26/2023,OMN,FL,ASO,ES,Federal Contract Tower,0,0,1,0,1,0,0,79,0,79,0,0,80,0,80,100,0,100,180
08/27/2023,OMN,FL,ASO,ES,Federal Contract Tower,0,0,4,0,4,0,0,34,0,34,0,0,38,0,38,62,0,62,100
08/28/2023,OMN,FL,ASO,ES,Federal Contract Tower,0,0,10,0,10,0,0,58,0,58,0,0,68,0,68,112,0,112,180
08/29/2023,OMN,FL,ASO,ES,Federal Contract Tower,0,0,3,0,3,0,0,54,0,54,0,0,57,0,57,106,0,106,163
08/30/2023,OMN,FL,ASO,ES,Federal Contract Tower,0,0,0,0,0,0,0,0,0,0,0,0,0,0,0,0,0,0,0
08/31/2023,OMN,FL,ASO,ES,Federal Contract Tower,0,0,8,0,8,0,0,75,0,75,0,0,83,0,83,82,0,82,165
01/01/2020,OMN,FL,ASO,ES,Federal Contract Tower,0,0,3,0,3,0,0,32,0,32,0,0,35,0,35,44,0,44,79
01/02/2020,OMN,FL,ASO,ES,Federal Contract Tower,0,0,15,0,15,0,0,213,0,213,0,0,228,0,228,238,0,238,466
01/03/2020,OMN,FL,ASO,ES,Federal Contract Tower,0,0,11,0,11,0,0,65,0,65,0,0,76,0,76,104,0,104,180
01/04/2020,OMN,FL,ASO,ES,Federal Contract Tower,0,0,7,0,7,0,0,6,0,6,0,0,13,0,13,0,0,0,13
01/05/2020,OMN,FL,ASO,ES,Federal Contract Tower,0,0,14,0,14,0,0,172,0,172,0,0,186,0,186,238,0,238,424
01/06/2020,OMN,FL,ASO,ES,Federal Contract Tower,0,0,16,0,16,0,0,210,0,210,0,0,226,0,226,328,0,328,554
01/07/2020,OMN,FL,ASO,ES,Federal Contract Tower,0,0,10,0,10,0,0,274,0,274,0,0,284,0,284,306,0,306,590
01/08/2020,OMN,FL,ASO,ES,Federal Contract Tower,0,0,17,0,17,0,0,264,0,264,0,0,281,0,281,228,0,228,509
01/09/2020,OMN,FL,ASO,ES,Federal Contract Tower,0,0,14,0,14,0,0,171,0,171,0,0,185,0,185,294,0,294,479
01/10/2020,OMN,FL,ASO,ES,Federal Contract Tower,0,0,17,0,17,0,0,142,0,142,0,0,159,0,159,178,0,178,337
01/11/2020,OMN,FL,ASO,ES,Federal Contract Tower,0,0,4,0,4,0,0,70,0,70,0,0,74,0,74,134,0,134,208
01/12/2020,OMN,FL,ASO,ES,Federal Contract Tower,0,0,17,0,17,0,0,67,0,67,0,0,84,0,84,130,0,130,214
01/13/2020,OMN,FL,ASO,ES,Federal Contract Tower,0,0,8,0,8,0,0,152,0,152,0,0,160,0,160,436,0,436,596
01/14/2020,OMN,FL,ASO,ES,Federal Contract Tower,0,0,20,0,20,0,0,194,0,194,0,0,214,0,214,278,0,278,492
01/15/2020,OMN,FL,ASO,ES,Federal Contract Tower,0,0,14,0,14,0,0,292,0,292,0,0,306,0,306,328,0,328,634
01/16/2020,OMN,FL,ASO,ES,Federal Contract Tower,0,0,6,0,6,0,0,157,0,157,0,0,163,0,163,334,0,334,497
01/17/2020,OMN,FL,ASO,ES,Federal Contract Tower,0,0,10,0,10,0,0,78,0,78,0,0,88,0,88,122,0,122,210
01/18/2020,OMN,FL,ASO,ES,Federal Contract Tower,0,0,12,0,12,0,0,113,0,113,0,0,125,0,125,158,0,158,283
01/19/2020,OMN,FL,ASO,ES,Federal Contract Tower,0,0,5,0,5,0,0,66,0,66,0,0,71,0,71,152,0,152,223
01/20/2020,OMN,FL,ASO,ES,Federal Contract Tower,0,0,8,0,8,0,0,124,0,124,0,0,132,0,132,350,0,350,482
01/21/2020,OMN,FL,ASO,ES,Federal Contract Tower,0,0,3,0,3,0,0,124,0,124,0,0,127,0,127,137,0,137,264
01/22/2020,OMN,FL,ASO,ES,Federal Contract Tower,0,0,2,0,2,0,0,18,0,18,0,0,20,0,20,2,0,2,22
01/23/2020,OMN,FL,ASO,ES,Federal Contract Tower,0,0,14,0,14,0,0,103,0,103,0,0,117,0,117,290,0,290,407
01/24/2020,OMN,FL,ASO,ES,Federal Contract Tower,0,0,12,0,12,0,0,199,0,199,0,0,211,0,211,410,0,410,621
01/25/2020,OMN,FL,ASO,ES,Federal Contract Tower,0,0,12,0,12,0,0,216,0,216,0,0,228,0,228,316,0,316,544
01/26/2020,OMN,FL,ASO,ES,Federal Contract Tower,0,0,13,0,13,0,0,116,0,116,0,0,129,0,129,204,0,204,333
01/27/2020,OMN,FL,ASO,ES,Federal Contract Tower,0,0,18,0,18,0,0,221,0,221,0,0,239,0,239,342,0,342,581
01/28/2020,OMN,FL,ASO,ES,Federal Contract Tower,0,0,24,0,24,0,0,248,0,248,0,0,272,0,272,351,0,351,623
01/29/2020,OMN,FL,ASO,ES,Federal Contract Tower,0,0,15,0,15,0,0,248,0,248,0,0,263,0,263,442,0,442,705
01/30/2020,OMN,FL,ASO,ES,Federal Contract Tower,0,0,7,0,7,0,0,26,0,26,0,0,33,0,33,28,0,28,61
01/31/2020,OMN,FL,ASO,ES,Federal Contract Tower,0,0,25,0,25,0,0,183,0,183,0,0,208,0,208,358,0,358,566
02/01/2020,OMN,FL,ASO,ES,Federal Contract Tower,0,0,8,0,8,0,0,7,0,7,0,0,15,0,15,2,0,2,17
02/02/2020,OMN,FL,ASO,ES,Federal Contract Tower,0,0,9,0,9,0,0,152,0,152,0,0,161,0,161,188,0,188,349
02/03/2020,OMN,FL,ASO,ES,Federal Contract Tower,0,0,17,0,17,0,0,188,0,188,0,0,205,0,205,271,0,271,476
02/04/2020,OMN,FL,ASO,ES,Federal Contract Tower,0,0,18,0,18,0,0,257,0,257,0,0,275,0,275,390,0,390,665
02/05/2020,OMN,FL,ASO,ES,Federal Contract Tower,0,0,8,0,8,0,0,321,0,321,0,0,329,0,329,290,0,290,619
02/06/2020,OMN,FL,ASO,ES,Federal Contract Tower,0,0,3,0,3,0,0,17,0,17,0,0,20,0,20,14,0,14,34
02/07/2020,OMN,FL,ASO,ES,Federal Contract Tower,0,0,5,0,5,0,0,39,0,39,0,0,44,0,44,146,0,146,190
02/08/2020,OMN,FL,ASO,ES,Federal Contract Tower,0,0,24,0,24,0,0,237,0,237,0,0,261,0,261,314,0,314,575
02/09/2020,OMN,FL,ASO,ES,Federal Contract Tower,0,0,10,0,10,0,0,125,0,125,0,0,135,0,135,238,0,238,373
02/10/2020,OMN,FL,ASO,ES,Federal Contract Tower,0,0,14,0,14,0,0,164,0,164,0,0,178,0,178,328,0,328,506
02/11/2020,OMN,FL,ASO,ES,Federal Contract Tower,0,0,20,0,20,0,0,173,0,173,0,0,193,0,193,219,0,219,412
02/12/2020,OMN,FL,ASO,ES,Federal Contract Tower,0,0,14,0,14,0,0,169,0,169,0,0,183,0,183,280,0,280,463
02/13/2020,OMN,FL,ASO,ES,Federal Contract Tower,0,0,12,0,12,0,0,88,0,88,0,0,100,0,100,70,0,70,170
02/14/2020,OMN,FL,ASO,ES,Federal Contract Tower,0,0,14,0,14,0,0,12,0,12,0,0,26,0,26,24,0,24,50
02/15/2020,OMN,FL,ASO,ES,Federal Contract Tower,0,0,20,0,20,0,0,119,0,119,0,0,139,0,139,52,0,52,191
02/16/2020,OMN,FL,ASO,ES,Federal Contract Tower,0,0,2,0,2,0,0,13,0,13,0,0,15,0,15,4,0,4,19
02/17/2020,OMN,FL,ASO,ES,Federal Contract Tower,0,0,18,0,18,0,0,121,0,121,0,0,139,0,139,296,0,296,435
02/18/2020,OMN,FL,ASO,ES,Federal Contract Tower,0,0,19,0,19,0,0,201,0,201,0,0,220,0,220,376,0,376,596
02/19/2020,OMN,FL,ASO,ES,Federal Contract Tower,0,0,22,0,22,0,0,283,0,283,0,0,305,0,305,396,0,396,701
02/20/2020,OMN,FL,ASO,ES,Federal Contract Tower,0,0,11,0,11,0,0,3,0,3,0,0,14,0,14,8,0,8,22
02/21/2020,OMN,FL,ASO,ES,Federal Contract Tower,0,0,1,0,1,0,0,2,0,2,0,0,3,0,3,8,0,8,11
02/22/2020,OMN,FL,ASO,ES,Federal Contract Tower,0,0,10,0,10,0,0,90,0,90,0,0,100,0,100,91,0,91,191
02/23/2020,OMN,FL,ASO,ES,Federal Contract Tower,0,0,11,0,11,0,0,157,0,157,0,0,168,0,168,294,0,294,462
02/24/2020,OMN,FL,ASO,ES,Federal Contract Tower,0,0,20,0,20,0,0,206,0,206,0,0,226,0,226,475,0,475,701
02/25/2020,OMN,FL,ASO,ES,Federal Contract Tower,0,0,10,0,10,0,0,223,0,223,0,0,233,0,233,328,0,328,561
02/26/2020,OMN,FL,ASO,ES,Federal Contract Tower,0,0,15,0,15,0,0,127,0,127,0,0,142,0,142,176,0,176,318
02/27/2020,OMN,FL,ASO,ES,Federal Contract Tower,0,0,18,0,18,0,0,204,0,204,0,0,222,0,222,332,0,332,554
02/28/2020,OMN,FL,ASO,ES,Federal Contract Tower,0,0,21,0,21,0,0,178,0,178,0,0,199,0,199,417,0,417,616
02/29/2020,OMN,FL,ASO,ES,Federal Contract Tower,0,0,18,0,18,0,0,145,0,145,0,0,163,0,163,148,0,148,311
03/01/2020,OMN,FL,ASO,ES,Federal Contract Tower,0,0,14,0,14,0,0,138,0,138,0,0,152,0,152,312,0,312,464
03/02/2020,OMN,FL,ASO,ES,Federal Contract Tower,0,0,17,0,17,0,0,225,0,225,0,0,242,0,242,488,0,488,730
03/03/2020,OMN,FL,ASO,ES,Federal Contract Tower,0,0,21,0,21,0,0,225,0,225,0,0,246,0,246,310,0,310,556
03/04/2020,OMN,FL,ASO,ES,Federal Contract Tower,0,0,17,0,17,0,0,289,0,289,0,0,306,0,306,368,0,368,674
03/05/2020,OMN,FL,ASO,ES,Federal Contract Tower,0,0,16,0,16,0,0,84,0,84,0,0,100,0,100,92,0,92,192
03/06/2020,OMN,FL,ASO,ES,Federal Contract Tower,0,0,24,0,24,0,0,112,0,112,0,0,136,0,136,338,0,338,474
03/07/2020,OMN,FL,ASO,ES,Federal Contract Tower,0,0,12,0,12,0,0,66,0,66,0,0,78,0,78,12,0,12,90
03/08/2020,OMN,FL,ASO,ES,Federal Contract Tower,0,0,7,0,7,0,0,117,0,117,0,0,124,0,124,140,0,140,264
03/09/2020,OMN,FL,ASO,ES,Federal Contract Tower,0,0,23,0,23,0,0,175,0,175,0,0,198,0,198,280,0,280,478
03/10/2020,OMN,FL,ASO,ES,Federal Contract Tower,0,0,21,0,21,0,0,228,0,228,0,0,249,0,249,288,0,288,537
03/11/2020,OMN,FL,ASO,ES,Federal Contract Tower,0,0,17,0,17,0,0,298,0,298,0,0,315,0,315,336,0,336,651
03/12/2020,OMN,FL,ASO,ES,Federal Contract Tower,0,0,20,0,20,0,0,222,0,222,0,0,242,0,242,450,0,450,692
03/13/2020,OMN,FL,ASO,ES,Federal Contract Tower,0,0,24,0,24,0,0,243,0,243,0,0,267,0,267,415,0,415,682
03/14/2020,OMN,FL,ASO,ES,Federal Contract Tower,0,0,14,0,14,0,0,199,0,199,0,0,213,0,213,332,0,332,545
03/15/2020,OMN,FL,ASO,ES,Federal Contract Tower,0,0,8,0,8,0,0,62,0,62,0,0,70,0,70,122,0,122,192
03/16/2020,OMN,FL,ASO,ES,Federal Contract Tower,0,0,21,0,21,0,0,121,0,121,0,0,142,0,142,230,0,230,372
03/17/2020,OMN,FL,ASO,ES,Federal Contract Tower,0,0,19,0,19,0,0,235,0,235,0,0,254,0,254,298,0,298,552
03/18/2020,OMN,FL,ASO,ES,Federal Contract Tower,0,0,20,0,20,0,0,249,0,249,0,0,269,0,269,302,0,302,571
03/19/2020,OMN,FL,ASO,ES,Federal Contract Tower,0,0,27,0,27,0,0,144,0,144,0,0,171,0,171,300,0,300,471
03/20/2020,OMN,FL,ASO,ES,Federal Contract Tower,0,0,20,0,20,0,0,185,0,185,0,0,205,0,205,418,0,418,623
03/21/2020,OMN,FL,ASO,ES,Federal Contract Tower,0,0,12,0,12,0,0,199,0,199,0,0,211,0,211,344,0,344,555
03/22/2020,OMN,FL,ASO,ES,Federal Contract Tower,0,0,10,0,10,0,0,83,0,83,0,0,93,0,93,152,0,152,245
03/23/2020,OMN,FL,ASO,ES,Federal Contract Tower,0,0,14,0,14,0,0,169,0,169,0,0,183,0,183,320,0,320,503
03/24/2020,OMN,FL,ASO,ES,Federal Contract Tower,0,0,19,0,19,0,0,202,0,202,0,0,221,0,221,298,0,298,519
03/25/2020,OMN,FL,ASO,ES,Federal Contract Tower,0,0,9,0,9,0,0,65,0,65,0,0,74,0,74,218,0,218,292
03/26/2020,OMN,FL,ASO,ES,Federal Contract Tower,0,0,23,0,23,0,0,42,0,42,0,0,65,0,65,107,0,107,172
03/27/2020,OMN,FL,ASO,ES,Federal Contract Tower,0,0,11,0,11,0,0,130,0,130,0,0,141,0,141,384,0,384,525
03/28/2020,OMN,FL,ASO,ES,Federal Contract Tower,0,0,11,0,11,0,0,191,0,191,0,0,202,0,202,198,0,198,400
03/29/2020,OMN,FL,ASO,ES,Federal Contract Tower,0,0,3,0,3,0,0,121,0,121,0,0,124,0,124,180,0,180,304
03/30/2020,OMN,FL,ASO,ES,Federal Contract Tower,0,0,5,0,5,0,0,170,0,170,0,0,175,0,175,346,0,346,521
03/31/2020,OMN,FL,ASO,ES,Federal Contract Tower,0,0,6,0,6,0,0,136,0,136,0,0,142,0,142,160,0,160,302
04/01/2020,OMN,FL,ASO,ES,Federal Contract Tower,0,0,5,0,5,0,0,192,0,192,0,0,197,0,197,312,0,312,509
04/02/2020,OMN,FL,ASO,ES,Federal Contract Tower,0,0,4,0,4,0,0,182,0,182,0,0,186,0,186,180,0,180,366
04/03/2020,OMN,FL,ASO,ES,Federal Contract Tower,0,0,3,0,3,0,0,61,0,61,0,0,64,0,64,180,0,180,244
04/04/2020,OMN,FL,ASO,ES,Federal Contract Tower,0,0,3,0,3,0,0,70,0,70,0,0,73,0,73,114,0,114,187
04/05/2020,OMN,FL,ASO,ES,Federal Contract Tower,0,0,3,0,3,0,0,4,0,4,0,0,7,0,7,2,0,2,9
04/06/2020,OMN,FL,ASO,ES,Federal Contract Tower,0,0,5,0,5,0,0,39,0,39,0,0,44,0,44,82,0,82,126
04/07/2020,OMN,FL,ASO,ES,Federal Contract Tower,0,0,5,0,5,0,0,77,0,77,0,0,82,0,82,138,0,138,220
04/08/2020,OMN,FL,ASO,ES,Federal Contract Tower,0,0,4,0,4,0,0,54,0,54,0,0,58,0,58,150,0,150,208
04/09/2020,OMN,FL,ASO,ES,Federal Contract Tower,0,0,5,0,5,0,0,23,0,23,0,0,28,0,28,44,0,44,72
04/10/2020,OMN,FL,ASO,ES,Federal Contract Tower,0,0,3,0,3,0,0,29,0,29,0,0,32,0,32,138,0,138,170
04/11/2020,OMN,FL,ASO,ES,Federal Contract Tower,0,0,10,0,10,0,0,95,0,95,0,0,105,0,105,150,0,150,255
04/12/2020,OMN,FL,ASO,ES,Federal Contract Tower,0,0,1,0,1,0,0,14,0,14,0,0,15,0,15,6,0,6,21
04/13/2020,OMN,FL,ASO,ES,Federal Contract Tower,0,0,0,0,0,0,0,25,0,25,0,0,25,0,25,22,0,22,47
04/14/2020,OMN,FL,ASO,ES,Federal Contract Tower,0,0,6,0,6,0,0,22,0,22,0,0,28,0,28,48,0,48,76
04/15/2020,OMN,FL,ASO,ES,Federal Contract Tower,0,0,1,0,1,0,0,19,0,19,0,0,20,0,20,18,0,18,38
04/16/2020,OMN,FL,ASO,ES,Federal Contract Tower,0,0,3,0,3,0,0,5,0,5,0,0,8,0,8,8,0,8,16
04/17/2020,OMN,FL,ASO,ES,Federal Contract Tower,0,0,2,0,2,0,0,21,0,21,0,0,23,0,23,44,0,44,67
04/18/2020,OMN,FL,ASO,ES,Federal Contract Tower,0,0,0,0,0,0,0,18,0,18,0,0,18,0,18,110,0,110,128
04/19/2020,OMN,FL,ASO,ES,Federal Contract Tower,0,0,6,0,6,0,0,81,0,81,0,0,87,0,87,126,0,126,213
04/20/2020,OMN,FL,ASO,ES,Federal Contract Tower,0,0,0,0,0,0,0,0,0,0,0,0,0,0,0,0,0,0,0
04/21/2020,OMN,FL,ASO,ES,Federal Contract Tower,0,0,12,0,12,0,0,148,0,148,0,0,160,0,160,258,0,258,418
04/22/2020,OMN,FL,ASO,ES,Federal Contract Tower,0,0,6,0,6,0,0,140,0,140,0,0,146,0,146,176,0,176,322
04/23/2020,OMN,FL,ASO,ES,Federal Contract Tower,0,0,2,0,2,0,0,90,0,90,0,0,92,0,92,102,0,102,194
04/24/2020,OMN,FL,ASO,ES,Federal Contract Tower,0,0,0,0,0,0,0,0,0,0,0,0,0,0,0,0,0,0,0
04/25/2020,OMN,FL,ASO,ES,Federal Contract Tower,0,0,4,0,4,0,0,34,0,34,0,0,38,0,38,154,0,154,192
04/26/2020,OMN,FL,ASO,ES,Federal Contract Tower,0,0,10,0,10,0,0,48,0,48,0,0,58,0,58,156,0,156,214
04/27/2020,OMN,FL,ASO,ES,Federal Contract Tower,0,0,8,0,8,0,0,69,0,69,0,0,77,0,77,289,0,289,366
04/28/2020,OMN,FL,ASO,ES,Federal Contract Tower,0,0,5,0,5,0,0,141,0,141,0,0,146,0,146,269,0,269,415
04/29/2020,OMN,FL,ASO,ES,Federal Contract Tower,0,0,3,0,3,0,0,70,0,70,0,0,73,0,73,152,0,152,225
04/30/2020,OMN,FL,ASO,ES,Federal Contract Tower,0,0,2,0,2,0,0,10,0,10,0,0,12,0,12,50,0,50,62
05/01/2020,OMN,FL,ASO,ES,Federal Contract Tower,0,0,11,0,11,0,0,169,0,169,0,0,180,0,180,220,0,220,400
05/02/2020,OMN,FL,ASO,ES,Federal Contract Tower,0,0,8,0,8,0,0,145,0,145,0,0,153,0,153,158,0,158,311
05/03/2020,OMN,FL,ASO,ES,Federal Contract Tower,0,0,8,0,8,0,0,82,0,82,0,0,90,0,90,134,0,134,224
05/04/2020,OMN,FL,ASO,ES,Federal Contract Tower,0,0,15,0,15,0,0,156,0,156,0,0,171,0,171,336,0,336,507
05/05/2020,OMN,FL,ASO,ES,Federal Contract Tower,0,0,8,0,8,0,0,189,0,189,0,0,197,0,197,196,0,196,393
05/06/2020,OMN,FL,ASO,ES,Federal Contract Tower,0,0,19,0,19,0,0,194,0,194,0,0,213,0,213,210,0,210,423
05/07/2020,OMN,FL,ASO,ES,Federal Contract Tower,0,0,15,0,15,0,0,189,0,189,0,0,204,0,204,222,0,222,426
05/08/2020,OMN,FL,ASO,ES,Federal Contract Tower,0,0,7,0,7,0,0,141,0,141,0,0,148,0,148,254,0,254,402
05/09/2020,OMN,FL,ASO,ES,Federal Contract Tower,0,0,9,0,9,0,0,97,0,97,0,0,106,0,106,158,0,158,264
05/10/2020,OMN,FL,ASO,ES,Federal Contract Tower,0,0,2,0,2,0,0,3,0,3,0,0,5,0,5,22,0,22,27
05/11/2020,OMN,FL,ASO,ES,Federal Contract Tower,0,0,11,0,11,0,0,132,0,132,0,0,143,0,143,252,0,252,395
05/12/2020,OMN,FL,ASO,ES,Federal Contract Tower,0,0,9,0,9,0,0,192,0,192,0,0,201,0,201,262,4,266,467
05/13/2020,OMN,FL,ASO,ES,Federal Contract Tower,0,0,14,0,14,0,0,186,0,186,0,0,200,0,200,252,0,252,452
05/14/2020,OMN,FL,ASO,ES,Federal Contract Tower,0,0,18,0,18,0,0,61,0,61,0,0,79,0,79,132,0,132,211
05/15/2020,OMN,FL,ASO,ES,Federal Contract Tower,0,0,14,0,14,0,0,101,0,101,0,0,115,0,115,142,0,142,257
05/16/2020,OMN,FL,ASO,ES,Federal Contract Tower,0,0,9,0,9,0,0,48,0,48,0,0,57,0,57,29,0,29,86
05/17/2020,OMN,FL,ASO,ES,Federal Contract Tower,0,0,10,0,10,0,0,24,0,24,0,0,34,0,34,70,0,70,104
05/18/2020,OMN,FL,ASO,ES,Federal Contract Tower,0,0,8,0,8,0,0,120,0,120,0,0,128,0,128,282,0,282,410
05/19/2020,OMN,FL,ASO,ES,Federal Contract Tower,0,0,17,0,17,0,0,140,0,140,0,0,157,0,157,252,0,252,409
05/20/2020,OMN,FL,ASO,ES,Federal Contract Tower,0,0,17,0,17,0,0,243,0,243,0,0,260,0,260,294,0,294,554
05/21/2020,OMN,FL,ASO,ES,Federal Contract Tower,0,0,18,0,18,0,0,189,0,189,0,0,207,0,207,322,0,322,529
05/22/2020,OMN,FL,ASO,ES,Federal Contract Tower,0,0,15,0,15,0,0,157,0,157,0,0,172,0,172,262,0,262,434
05/23/2020,OMN,FL,ASO,ES,Federal Contract Tower,0,0,13,0,13,0,0,95,0,95,0,0,108,0,108,164,0,164,272
05/24/2020,OMN,FL,ASO,ES,Federal Contract Tower,0,0,6,0,6,0,0,57,0,57,0,0,63,0,63,76,0,76,139
05/25/2020,OMN,FL,ASO,ES,Federal Contract Tower,0,0,13,0,13,0,0,53,0,53,0,0,66,0,66,90,0,90,156
05/26/2020,OMN,FL,ASO,ES,Federal Contract Tower,0,0,12,0,12,0,0,4,0,4,0,0,16,0,16,20,0,20,36
05/27/2020,OMN,FL,ASO,ES,Federal Contract Tower,0,0,11,0,11,0,0,47,0,47,0,0,58,0,58,106,0,106,164
05/28/2020,OMN,FL,ASO,ES,Federal Contract Tower,0,0,14,0,14,0,0,116,0,116,0,0,130,0,130,362,0,362,492
05/29/2020,OMN,FL,ASO,ES,Federal Contract Tower,0,0,17,0,17,0,0,172,0,172,0,0,189,0,189,214,0,214,403
05/30/2020,OMN,FL,ASO,ES,Federal Contract Tower,0,0,9,0,9,0,0,73,0,73,0,0,82,0,82,100,0,100,182
05/31/2020,OMN,FL,ASO,ES,Federal Contract Tower,0,0,13,0,13,0,0,71,0,71,0,0,84,0,84,114,0,114,198
06/01/2020,OMN,FL,ASO,ES,Federal Contract Tower,0,0,23,0,23,0,0,52,0,52,0,0,75,0,75,136,0,136,211
06/02/2020,OMN,FL,ASO,ES,Federal Contract Tower,0,0,21,0,21,0,0,147,0,147,0,0,168,0,168,134,0,134,302
06/03/2020,OMN,FL,ASO,ES,Federal Contract Tower,0,0,31,0,31,0,0,207,0,207,0,0,238,0,238,338,0,338,576
06/04/2020,OMN,FL,ASO,ES,Federal Contract Tower,0,0,11,0,11,0,0,16,0,16,0,0,27,0,27,2,0,2,29
06/05/2020,OMN,FL,ASO,ES,Federal Contract Tower,0,0,22,0,22,0,0,177,0,177,0,0,199,0,199,252,0,252,451
06/06/2020,OMN,FL,ASO,ES,Federal Contract Tower,0,0,16,0,16,0,0,35,0,35,0,0,51,0,51,76,0,76,127
06/07/2020,OMN,FL,ASO,ES,Federal Contract Tower,0,0,7,0,7,0,0,7,0,7,0,0,14,0,14,18,0,18,32
06/08/2020,OMN,FL,ASO,ES,Federal Contract Tower,0,0,15,0,15,0,0,105,0,105,0,0,120,0,120,122,0,122,242
06/09/2020,OMN,FL,ASO,ES,Federal Contract Tower,0,0,23,0,23,0,0,136,0,136,0,0,159,0,159,250,0,250,409
06/10/2020,OMN,FL,ASO,ES,Federal Contract Tower,0,0,10,0,10,0,0,157,0,157,0,0,167,0,167,164,0,164,331
06/11/2020,OMN,FL,ASO,ES,Federal Contract Tower,0,0,16,0,16,0,0,126,0,126,0,0,142,0,142,244,0,244,386
06/12/2020,OMN,FL,ASO,ES,Federal Contract Tower,0,0,21,0,21,0,0,178,0,178,0,0,199,0,199,242,0,242,441
06/13/2020,OMN,FL,ASO,ES,Federal Contract Tower,0,0,5,0,5,0,0,34,0,34,0,0,39,0,39,88,0,88,127
06/14/2020,OMN,FL,ASO,ES,Federal Contract Tower,0,0,8,0,8,0,0,29,0,29,0,0,37,0,37,54,0,54,91
06/15/2020,OMN,FL,ASO,ES,Federal Contract Tower,0,0,6,0,6,0,0,139,0,139,0,0,145,0,145,246,0,246,391
06/16/2020,OMN,FL,ASO,ES,Federal Contract Tower,0,0,13,0,13,0,0,242,0,242,0,0,255,0,255,254,0,254,509
06/17/2020,OMN,FL,ASO,ES,Federal Contract Tower,0,0,18,0,18,0,0,208,0,208,0,0,226,0,226,244,0,244,470
06/18/2020,OMN,FL,ASO,ES,Federal Contract Tower,0,0,19,0,19,0,0,186,0,186,0,0,205,0,205,268,0,268,473
06/19/2020,OMN,FL,ASO,ES,Federal Contract Tower,0,0,6,0,6,0,0,73,0,73,0,0,79,0,79,164,0,164,243
06/20/2020,OMN,FL,ASO,ES,Federal Contract Tower,0,0,17,0,17,0,0,49,0,49,0,0,66,0,66,82,0,82,148
06/21/2020,OMN,FL,ASO,ES,Federal Contract Tower,0,0,12,0,12,0,0,88,0,88,0,0,100,0,100,108,0,108,208
06/22/2020,OMN,FL,ASO,ES,Federal Contract Tower,0,0,12,0,12,0,0,153,0,153,0,0,165,0,165,198,0,198,363
06/23/2020,OMN,FL,ASO,ES,Federal Contract Tower,0,0,13,0,13,0,0,115,0,115,0,0,128,0,128,182,0,182,310
06/24/2020,OMN,FL,ASO,ES,Federal Contract Tower,0,0,25,0,25,0,0,180,0,180,0,0,205,0,205,248,0,248,453
06/25/2020,OMN,FL,ASO,ES,Federal Contract Tower,0,0,18,0,18,0,0,207,0,207,0,0,225,0,225,320,0,320,545
06/26/2020,OMN,FL,ASO,ES,Federal Contract Tower,0,0,20,0,20,0,0,202,0,202,0,0,222,0,222,280,0,280,502
06/27/2020,OMN,FL,ASO,ES,Federal Contract Tower,0,0,10,0,10,0,0,166,0,166,0,0,176,0,176,166,0,166,342
06/28/2020,OMN,FL,ASO,ES,Federal Contract Tower,0,0,3,0,3,0,0,20,0,20,0,0,23,0,23,26,0,26,49
06/29/2020,OMN,FL,ASO,ES,Federal Contract Tower,0,0,11,0,11,0,0,141,0,141,0,0,152,0,152,310,0,310,462
06/30/2020,OMN,FL,ASO,ES,Federal Contract Tower,0,0,14,0,14,0,0,119,0,119,0,0,133,0,133,274,0,274,407
07/01/2020,OMN,FL,ASO,ES,Federal Contract Tower,0,0,14,0,14,0,0,169,0,169,0,0,183,0,183,140,0,140,323
07/02/2020,OMN,FL,ASO,ES,Federal Contract Tower,0,0,9,0,9,0,0,126,0,126,0,0,135,0,135,150,0,150,285
07/03/2020,OMN,FL,ASO,ES,Federal Contract Tower,0,0,12,0,12,0,0,99,0,99,0,0,111,0,111,159,0,159,270
07/04/2020,OMN,FL,ASO,ES,Federal Contract Tower,0,0,7,0,7,0,0,81,0,81,0,0,88,0,88,44,0,44,132
07/05/2020,OMN,FL,ASO,ES,Federal Contract Tower,0,0,13,0,13,0,0,26,0,26,0,0,39,0,39,58,0,58,97
07/06/2020,OMN,FL,ASO,ES,Federal Contract Tower,0,0,14,0,14,0,0,62,0,62,0,0,76,0,76,114,0,114,190
07/07/2020,OMN,FL,ASO,ES,Federal Contract Tower,0,0,12,0,12,0,0,133,0,133,0,0,145,0,145,154,0,154,299
07/08/2020,OMN,FL,ASO,ES,Federal Contract Tower,0,0,10,0,10,0,0,99,0,99,0,0,109,0,109,50,0,50,159
07/09/2020,OMN,FL,ASO,ES,Federal Contract Tower,0,0,19,0,19,0,0,158,0,158,0,0,177,0,177,250,0,250,427
07/10/2020,OMN,FL,ASO,ES,Federal Contract Tower,0,0,23,0,23,0,0,127,0,127,0,0,150,0,150,234,0,234,384
07/11/2020,OMN,FL,ASO,ES,Federal Contract Tower,0,0,11,0,11,0,0,48,0,48,0,0,59,0,59,154,0,154,213
07/12/2020,OMN,FL,ASO,ES,Federal Contract Tower,0,0,4,0,4,0,0,57,0,57,0,0,61,0,61,188,0,188,249
07/13/2020,OMN,FL,ASO,ES,Federal Contract Tower,0,0,6,0,6,0,0,117,0,117,0,0,123,0,123,200,0,200,323
07/14/2020,OMN,FL,ASO,ES,Federal Contract Tower,0,0,5,0,5,0,0,128,0,128,0,0,133,0,133,214,0,214,347
07/15/2020,OMN,FL,ASO,ES,Federal Contract Tower,0,0,8,0,8,0,0,204,0,204,0,0,212,0,212,230,0,230,442
07/16/2020,OMN,FL,ASO,ES,Federal Contract Tower,0,0,7,0,7,0,0,154,0,154,0,0,161,0,161,208,0,208,369
07/17/2020,OMN,FL,ASO,ES,Federal Contract Tower,0,0,12,0,12,0,0,119,0,119,0,0,131,0,131,164,0,164,295
07/18/2020,OMN,FL,ASO,ES,Federal Contract Tower,0,0,17,0,17,0,0,73,0,73,0,0,90,0,90,86,0,86,176
07/19/2020,OMN,FL,ASO,ES,Federal Contract Tower,0,0,10,0,10,0,0,54,0,54,0,0,64,0,64,68,0,68,132
07/20/2020,OMN,FL,ASO,ES,Federal Contract Tower,0,0,12,0,12,0,0,94,0,94,0,0,106,0,106,210,0,210,316
07/21/2020,OMN,FL,ASO,ES,Federal Contract Tower,0,0,23,0,23,0,0,74,0,74,0,0,97,0,97,192,0,192,289
07/22/2020,OMN,FL,ASO,ES,Federal Contract Tower,0,0,12,0,12,0,0,51,0,51,0,0,63,0,63,186,0,186,249
07/23/2020,OMN,FL,ASO,ES,Federal Contract Tower,0,0,12,0,12,0,0,74,0,74,0,0,86,0,86,50,0,50,136
07/24/2020,OMN,FL,ASO,ES,Federal Contract Tower,0,0,27,0,27,0,0,118,0,118,0,0,145,0,145,206,0,206,351
07/25/2020,OMN,FL,ASO,ES,Federal Contract Tower,0,0,15,0,15,0,0,174,0,174,0,0,189,0,189,102,0,102,291
07/26/2020,OMN,FL,ASO,ES,Federal Contract Tower,0,0,6,0,6,0,0,32,0,32,0,0,38,0,38,34,0,34,72
07/27/2020,OMN,FL,ASO,ES,Federal Contract Tower,0,0,15,0,15,0,0,86,0,86,0,0,101,0,101,272,0,272,373
07/28/2020,OMN,FL,ASO,ES,Federal Contract Tower,0,0,12,0,12,0,0,125,0,125,0,0,137,0,137,214,0,214,351
07/29/2020,OMN,FL,ASO,ES,Federal Contract Tower,0,0,16,0,16,0,0,160,0,160,0,0,176,0,176,172,0,172,348
07/30/2020,OMN,FL,ASO,ES,Federal Contract Tower,0,0,18,0,18,0,0,165,0,165,0,0,183,0,183,112,0,112,295
07/31/2020,OMN,FL,ASO,ES,Federal Contract Tower,0,0,26,0,26,0,0,100,0,100,0,0,126,0,126,228,0,228,354
08/01/2020,OMN,FL,ASO,ES,Federal Contract Tower,0,0,12,0,12,0,0,107,0,107,0,0,119,0,119,178,0,178,297
08/02/2020,OMN,FL,ASO,ES,Federal Contract Tower,0,0,0,0,0,0,0,0,0,0,0,0,0,0,0,0,0,0,0
08/03/2020,OMN,FL,ASO,ES,Federal Contract Tower,0,0,5,0,5,0,0,11,0,11,0,0,16,0,16,34,0,34,50
08/04/2020,OMN,FL,ASO,ES,Federal Contract Tower,0,0,14,0,14,0,0,145,0,145,0,0,159,0,159,132,0,132,291
08/05/2020,OMN,FL,ASO,ES,Federal Contract Tower,0,0,13,0,13,0,0,122,0,122,0,0,135,0,135,138,0,138,273
08/06/2020,OMN,FL,ASO,ES,Federal Contract Tower,0,0,10,0,10,0,0,155,0,155,0,0,165,0,165,212,0,212,377
08/07/2020,OMN,FL,ASO,ES,Federal Contract Tower,0,0,13,0,13,0,0,127,0,127,0,0,140,0,140,188,0,188,328
08/08/2020,OMN,FL,ASO,ES,Federal Contract Tower,0,0,13,0,13,0,0,146,0,146,0,0,159,0,159,78,0,78,237
08/09/2020,OMN,FL,ASO,ES,Federal Contract Tower,0,0,6,0,6,0,0,36,0,36,0,0,42,0,42,84,0,84,126
08/10/2020,OMN,FL,ASO,ES,Federal Contract Tower,0,0,17,0,17,0,0,105,0,105,0,0,122,0,122,224,0,224,346
08/11/2020,OMN,FL,ASO,ES,Federal Contract Tower,0,0,16,0,16,0,0,154,0,154,0,0,170,0,170,114,0,114,284
08/12/2020,OMN,FL,ASO,ES,Federal Contract Tower,0,0,20,0,20,0,0,139,0,139,0,0,159,0,159,80,0,80,239
08/13/2020,OMN,FL,ASO,ES,Federal Contract Tower,0,0,14,0,14,0,0,80,0,80,0,0,94,0,94,134,0,134,228
08/14/2020,OMN,FL,ASO,ES,Federal Contract Tower,0,0,13,0,13,0,0,120,0,120,0,0,133,0,133,148,0,148,281
08/15/2020,OMN,FL,ASO,ES,Federal Contract Tower,0,0,10,0,10,0,0,111,0,111,0,0,121,0,121,94,0,94,215
08/16/2020,OMN,FL,ASO,ES,Federal Contract Tower,0,0,1,0,1,0,0,34,0,34,0,0,35,0,35,46,0,46,81
08/17/2020,OMN,FL,ASO,ES,Federal Contract Tower,0,0,6,0,6,0,0,81,0,81,0,0,87,0,87,182,0,182,269
08/18/2020,OMN,FL,ASO,ES,Federal Contract Tower,0,0,13,0,13,0,0,94,0,94,0,0,107,0,107,128,0,128,235
08/19/2020,OMN,FL,ASO,ES,Federal Contract Tower,0,0,11,0,11,0,0,157,0,157,0,0,168,0,168,178,0,178,346
08/20/2020,OMN,FL,ASO,ES,Federal Contract Tower,0,0,13,0,13,0,0,181,0,181,0,0,194,0,194,240,0,240,434
08/21/2020,OMN,FL,ASO,ES,Federal Contract Tower,0,0,11,0,11,0,0,143,0,143,0,0,154,0,154,180,0,180,334
08/22/2020,OMN,FL,ASO,ES,Federal Contract Tower,0,0,12,0,12,0,0,58,0,58,0,0,70,0,70,82,0,82,152
08/23/2020,OMN,FL,ASO,ES,Federal Contract Tower,0,0,15,0,15,0,0,44,0,44,0,0,59,0,59,114,0,114,173
08/24/2020,OMN,FL,ASO,ES,Federal Contract Tower,0,0,9,0,9,0,0,69,0,69,0,0,78,0,78,76,0,76,154
08/25/2020,OMN,FL,ASO,ES,Federal Contract Tower,0,0,11,0,11,0,0,88,0,88,0,0,99,0,99,174,0,174,273
08/26/2020,OMN,FL,ASO,ES,Federal Contract Tower,0,2,22,0,24,0,0,126,0,126,0,2,148,0,150,188,0,188,338
08/27/2020,OMN,FL,ASO,ES,Federal Contract Tower,0,0,14,0,14,0,0,117,0,117,0,0,131,0,131,180,0,180,311
08/28/2020,OMN,FL,ASO,ES,Federal Contract Tower,0,0,26,0,26,0,0,168,0,168,0,0,194,0,194,234,0,234,428
08/29/2020,OMN,FL,ASO,ES,Federal Contract Tower,0,0,6,0,6,0,0,95,0,95,0,0,101,0,101,80,0,80,181
08/30/2020,OMN,FL,ASO,ES,Federal Contract Tower,0,0,9,0,9,0,0,6,0,6,0,0,15,0,15,22,0,22,37
08/31/2020,OMN,FL,ASO,ES,Federal Contract Tower,0,0,5,0,5,0,0,35,0,35,0,0,40,0,40,60,0,60,100
09/01/2020,OMN,FL,ASO,ES,Federal Contract Tower,0,0,20,0,20,0,0,61,0,61,0,0,81,0,81,78,0,78,159
09/02/2020,OMN,FL,ASO,ES,Federal Contract Tower,0,0,17,0,17,0,0,137,0,137,0,0,154,0,154,234,0,234,388
09/03/2020,OMN,FL,ASO,ES,Federal Contract Tower,0,0,13,0,13,0,0,113,0,113,0,0,126,0,126,160,0,160,286
09/04/2020,OMN,FL,ASO,ES,Federal Contract Tower,0,0,19,0,19,0,0,120,0,120,0,0,139,0,139,124,0,124,263
09/05/2020,OMN,FL,ASO,ES,Federal Contract Tower,0,0,18,0,18,0,0,88,0,88,0,0,106,0,106,108,0,108,214
09/06/2020,OMN,FL,ASO,ES,Federal Contract Tower,0,0,5,0,5,0,0,60,0,60,0,0,65,0,65,46,0,46,111
09/07/2020,OMN,FL,ASO,ES,Federal Contract Tower,0,0,21,0,21,0,0,30,0,30,0,0,51,0,51,118,0,118,169
09/08/2020,OMN,FL,ASO,ES,Federal Contract Tower,0,0,12,0,12,0,0,49,0,49,0,0,61,0,61,90,0,90,151
09/09/2020,OMN,FL,ASO,ES,Federal Contract Tower,0,0,21,0,21,0,0,72,0,72,0,0,93,0,93,124,0,124,217
09/10/2020,OMN,FL,ASO,ES,Federal Contract Tower,0,0,17,0,17,0,0,127,0,127,0,0,144,0,144,88,0,88,232
09/11/2020,OMN,FL,ASO,ES,Federal Contract Tower,0,0,21,0,21,0,0,41,0,41,0,0,62,0,62,56,4,60,122
09/12/2020,OMN,FL,ASO,ES,Federal Contract Tower,0,0,13,0,13,0,0,29,0,29,0,0,42,0,42,18,0,18,60
09/13/2020,OMN,FL,ASO,ES,Federal Contract Tower,0,0,3,0,3,0,0,2,0,2,0,0,5,0,5,10,0,10,15
09/14/2020,OMN,FL,ASO,ES,Federal Contract Tower,0,0,15,0,15,0,0,100,0,100,0,0,115,0,115,200,0,200,315
09/15/2020,OMN,FL,ASO,ES,Federal Contract Tower,0,0,32,0,32,0,0,119,0,119,0,0,151,0,151,160,0,160,311
09/16/2020,OMN,FL,ASO,ES,Federal Contract Tower,0,0,21,0,21,0,0,112,0,112,0,0,133,0,133,122,0,122,255
09/17/2020,OMN,FL,ASO,ES,Federal Contract Tower,0,0,10,0,10,0,0,47,0,47,0,0,57,0,57,102,0,102,159
09/18/2020,OMN,FL,ASO,ES,Federal Contract Tower,0,0,22,0,22,0,0,97,0,97,0,0,119,0,119,274,0,274,393
09/19/2020,OMN,FL,ASO,ES,Federal Contract Tower,0,0,9,0,9,0,0,53,0,53,0,0,62,0,62,52,0,52,114
09/20/2020,OMN,FL,ASO,ES,Federal Contract Tower,0,0,3,0,3,0,0,1,0,1,0,0,4,0,4,0,0,0,4
09/21/2020,OMN,FL,ASO,ES,Federal Contract Tower,0,0,5,0,5,0,0,24,0,24,0,0,29,0,29,0,0,0,29
09/22/2020,OMN,FL,ASO,ES,Federal Contract Tower,0,0,31,0,31,0,0,81,0,81,0,0,112,0,112,160,0,160,272
09/23/2020,OMN,FL,ASO,ES,Federal Contract Tower,0,0,28,0,28,0,0,158,0,158,0,0,186,0,186,284,0,284,470
09/24/2020,OMN,FL,ASO,ES,Federal Contract Tower,0,0,11,0,11,0,0,136,0,136,0,0,147,0,147,256,0,256,403
09/25/2020,OMN,FL,ASO,ES,Federal Contract Tower,0,0,21,0,21,0,0,105,0,105,0,0,126,0,126,288,0,288,414
09/26/2020,OMN,FL,ASO,ES,Federal Contract Tower,0,0,20,0,20,0,0,131,0,131,0,0,151,0,151,239,0,239,390
09/27/2020,OMN,FL,ASO,ES,Federal Contract Tower,0,0,6,0,6,0,0,35,0,35,0,0,41,0,41,98,0,98,139
09/28/2020,OMN,FL,ASO,ES,Federal Contract Tower,0,0,12,0,12,0,0,93,0,93,0,0,105,0,105,196,0,196,301
09/29/2020,OMN,FL,ASO,ES,Federal Contract Tower,0,0,5,0,5,0,0,94,0,94,0,0,99,0,99,194,0,194,293
09/30/2020,OMN,FL,ASO,ES,Federal Contract Tower,0,0,17,0,17,0,0,201,0,201,0,0,218,0,218,290,0,290,508
10/01/2020,OMN,FL,ASO,ES,Federal Contract Tower,0,0,20,0,20,0,0,161,0,161,0,0,181,0,181,252,0,252,433
10/02/2020,OMN,FL,ASO,ES,Federal Contract Tower,0,0,14,0,14,0,0,176,0,176,0,0,190,0,190,381,0,381,571
10/03/2020,OMN,FL,ASO,ES,Federal Contract Tower,0,0,12,0,12,0,0,91,0,91,0,0,103,0,103,50,0,50,153
10/04/2020,OMN,FL,ASO,ES,Federal Contract Tower,0,0,4,0,4,0,0,3,0,3,0,0,7,0,7,6,0,6,13
10/05/2020,OMN,FL,ASO,ES,Federal Contract Tower,0,0,13,0,13,0,0,42,0,42,0,0,55,0,55,80,0,80,135
10/06/2020,OMN,FL,ASO,ES,Federal Contract Tower,0,0,11,0,11,0,0,113,0,113,0,0,124,0,124,254,0,254,378
10/07/2020,OMN,FL,ASO,ES,Federal Contract Tower,0,0,12,0,12,0,0,32,0,32,0,0,44,0,44,24,0,24,68
10/08/2020,OMN,FL,ASO,ES,Federal Contract Tower,0,0,21,0,21,0,0,87,0,87,0,0,108,0,108,172,0,172,280
10/09/2020,OMN,FL,ASO,ES,Federal Contract Tower,0,0,13,0,13,0,0,78,0,78,0,0,91,0,91,130,0,130,221
10/10/2020,OMN,FL,ASO,ES,Federal Contract Tower,0,0,12,0,12,0,0,56,0,56,0,0,68,0,68,46,0,46,114
10/11/2020,OMN,FL,ASO,ES,Federal Contract Tower,0,0,12,0,12,0,0,12,0,12,0,0,24,0,24,8,0,8,32
10/12/2020,OMN,FL,ASO,ES,Federal Contract Tower,0,0,24,0,24,0,0,94,0,94,0,0,118,0,118,226,0,226,344
10/13/2020,OMN,FL,ASO,ES,Federal Contract Tower,0,0,21,0,21,0,0,215,0,215,0,0,236,0,236,370,0,370,606
10/14/2020,OMN,FL,ASO,ES,Federal Contract Tower,0,0,19,0,19,0,0,214,0,214,0,0,233,0,233,252,0,252,485
10/15/2020,OMN,FL,ASO,ES,Federal Contract Tower,0,0,20,0,20,0,0,88,0,88,0,0,108,0,108,290,0,290,398
10/16/2020,OMN,FL,ASO,ES,Federal Contract Tower,0,0,26,0,26,0,0,183,0,183,0,0,209,0,209,330,0,330,539
10/17/2020,OMN,FL,ASO,ES,Federal Contract Tower,0,0,13,0,13,0,0,75,0,75,0,0,88,0,88,90,0,90,178
10/18/2020,OMN,FL,ASO,ES,Federal Contract Tower,0,0,26,0,26,0,0,16,0,16,0,0,42,0,42,32,0,32,74
10/19/2020,OMN,FL,ASO,ES,Federal Contract Tower,0,0,16,0,16,0,0,47,0,47,0,0,63,0,63,110,0,110,173
10/20/2020,OMN,FL,ASO,ES,Federal Contract Tower,0,0,17,0,17,0,0,80,0,80,0,0,97,0,97,246,0,246,343
10/21/2020,OMN,FL,ASO,ES,Federal Contract Tower,0,0,26,0,26,0,0,101,0,101,0,0,127,0,127,210,0,210,337
10/22/2020,OMN,FL,ASO,ES,Federal Contract Tower,0,0,16,0,16,0,0,80,0,80,0,0,96,0,96,160,0,160,256
10/23/2020,OMN,FL,ASO,ES,Federal Contract Tower,0,0,18,0,18,0,0,71,0,71,0,0,89,0,89,228,0,228,317
10/24/2020,OMN,FL,ASO,ES,Federal Contract Tower,0,0,19,0,19,0,0,66,0,66,0,0,85,0,85,122,0,122,207
10/25/2020,OMN,FL,ASO,ES,Federal Contract Tower,0,0,7,0,7,0,0,53,0,53,0,0,60,0,60,88,0,88,148
10/26/2020,OMN,FL,ASO,ES,Federal Contract Tower,0,0,14,0,14,0,0,84,0,84,0,0,98,0,98,404,0,404,502
10/27/2020,OMN,FL,ASO,ES,Federal Contract Tower,0,0,10,0,10,0,0,92,0,92,0,0,102,0,102,258,0,258,360
10/28/2020,OMN,FL,ASO,ES,Federal Contract Tower,0,0,20,0,20,0,0,151,0,151,0,0,171,0,171,114,0,114,285
10/29/2020,OMN,FL,ASO,ES,Federal Contract Tower,0,0,12,0,12,0,0,82,0,82,0,0,94,0,94,146,0,146,240
10/30/2020,OMN,FL,ASO,ES,Federal Contract Tower,0,0,19,0,19,0,0,147,0,147,0,0,166,0,166,319,0,319,485
10/31/2020,OMN,FL,ASO,ES,Federal Contract Tower,0,0,16,0,16,0,0,86,0,86,0,0,102,0,102,130,0,130,232
11/01/2020,OMN,FL,ASO,ES,Federal Contract Tower,0,0,11,0,11,0,0,47,0,47,0,0,58,0,58,68,0,68,126
11/02/2020,OMN,FL,ASO,ES,Federal Contract Tower,0,0,4,0,4,0,0,28,0,28,0,0,32,0,32,34,0,34,66
11/03/2020,OMN,FL,ASO,ES,Federal Contract Tower,0,0,13,0,13,0,0,153,0,153,0,0,166,0,166,324,0,324,490
11/04/2020,OMN,FL,ASO,ES,Federal Contract Tower,0,0,19,0,19,0,0,95,0,95,0,0,114,0,114,244,0,244,358
11/05/2020,OMN,FL,ASO,ES,Federal Contract Tower,0,0,14,0,14,0,0,107,0,107,0,0,121,0,121,252,0,252,373
11/06/2020,OMN,FL,ASO,ES,Federal Contract Tower,0,0,13,0,13,0,0,124,0,124,0,0,137,0,137,294,0,294,431
11/07/2020,OMN,FL,ASO,ES,Federal Contract Tower,0,0,12,0,12,0,0,41,0,41,0,0,53,0,53,86,0,86,139
11/08/2020,OMN,FL,ASO,ES,Federal Contract Tower,0,0,3,0,3,0,0,4,0,4,0,0,7,0,7,4,0,4,11
11/09/2020,OMN,FL,ASO,ES,Federal Contract Tower,0,0,4,0,4,0,0,0,0,0,0,0,4,0,4,2,0,2,6
11/10/2020,OMN,FL,ASO,ES,Federal Contract Tower,0,0,9,0,9,0,0,21,0,21,0,0,30,0,30,36,0,36,66
11/11/2020,OMN,FL,ASO,ES,Federal Contract Tower,0,0,19,0,19,0,0,7,0,7,0,0,26,0,26,24,0,24,50
11/13/2020,OMN,FL,ASO,ES,Federal Contract Tower,0,0,21,0,21,0,0,98,0,98,0,0,119,0,119,246,0,246,365
11/14/2020,OMN,FL,ASO,ES,Federal Contract Tower,0,0,25,0,25,0,0,115,0,115,0,0,140,0,140,256,0,256,396
11/15/2020,OMN,FL,ASO,ES,Federal Contract Tower,0,0,9,0,9,0,0,90,0,90,0,0,99,0,99,152,0,152,251
11/16/2020,OMN,FL,ASO,ES,Federal Contract Tower,0,0,24,0,24,0,0,195,0,195,0,0,219,0,219,320,0,320,539
11/17/2020,OMN,FL,ASO,ES,Federal Contract Tower,0,0,13,0,13,0,0,224,0,224,0,0,237,0,237,364,0,364,601
11/18/2020,OMN,FL,ASO,ES,Federal Contract Tower,0,0,9,0,9,0,0,88,0,88,0,0,97,0,97,96,0,96,193
11/19/2020,OMN,FL,ASO,ES,Federal Contract Tower,0,0,21,0,21,0,0,120,0,120,0,0,141,0,141,186,0,186,327
11/20/2020,OMN,FL,ASO,ES,Federal Contract Tower,0,0,12,0,12,0,0,203,0,203,0,0,215,0,215,242,0,242,457
11/21/2020,OMN,FL,ASO,ES,Federal Contract Tower,0,0,22,0,22,0,0,145,0,145,0,0,167,0,167,130,0,130,297
11/22/2020,OMN,FL,ASO,ES,Federal Contract Tower,0,0,2,0,2,0,0,0,0,0,0,0,2,0,2,2,0,2,4
11/23/2020,OMN,FL,ASO,ES,Federal Contract Tower,0,0,12,0,12,0,0,157,0,157,0,0,169,0,169,404,0,404,573
11/24/2020,OMN,FL,ASO,ES,Federal Contract Tower,0,0,9,0,9,0,0,166,0,166,0,0,175,0,175,298,0,298,473
11/25/2020,OMN,FL,ASO,ES,Federal Contract Tower,0,0,17,0,17,0,0,178,0,178,0,0,195,0,195,170,0,170,365
11/26/2020,OMN,FL,ASO,ES,Federal Contract Tower,0,0,4,0,4,0,0,20,0,20,0,0,24,0,24,2,0,2,26
11/27/2020,OMN,FL,ASO,ES,Federal Contract Tower,0,0,6,0,6,0,0,189,0,189,0,0,195,0,195,260,0,260,455
11/28/2020,OMN,FL,ASO,ES,Federal Contract Tower,0,0,12,0,12,0,0,146,0,146,0,0,158,0,158,126,0,126,284
11/29/2020,OMN,FL,ASO,ES,Federal Contract Tower,0,0,15,0,15,0,0,43,0,43,0,0,58,0,58,116,0,116,174
11/30/2020,OMN,FL,ASO,ES,Federal Contract Tower,0,0,14,0,14,0,0,73,0,73,0,0,87,0,87,154,0,154,241
12/01/2020,OMN,FL,ASO,ES,Federal Contract Tower,0,0,18,0,18,0,0,122,0,122,0,0,140,0,140,248,0,248,388
12/02/2020,OMN,FL,ASO,ES,Federal Contract Tower,0,0,16,0,16,0,0,240,0,240,0,0,256,0,256,250,0,250,506
12/03/2020,OMN,FL,ASO,ES,Federal Contract Tower,0,0,12,0,12,0,0,177,0,177,0,0,189,0,189,352,0,352,541
12/04/2020,OMN,FL,ASO,ES,Federal Contract Tower,0,0,5,0,5,0,0,243,0,243,0,0,248,0,248,342,0,342,590
12/05/2020,OMN,FL,ASO,ES,Federal Contract Tower,0,0,16,0,16,0,0,175,0,175,0,0,191,0,191,190,0,190,381
12/06/2020,OMN,FL,ASO,ES,Federal Contract Tower,0,0,10,0,10,0,0,92,0,92,0,0,102,0,102,198,0,198,300
12/07/2020,OMN,FL,ASO,ES,Federal Contract Tower,0,0,17,0,17,0,0,56,0,56,0,0,73,0,73,72,0,72,145
12/08/2020,OMN,FL,ASO,ES,Federal Contract Tower,0,0,10,0,10,0,0,140,0,140,0,0,150,0,150,337,0,337,487
12/09/2020,OMN,FL,ASO,ES,Federal Contract Tower,0,0,11,0,11,0,0,159,0,159,0,0,170,0,170,392,0,392,562
12/10/2020,OMN,FL,ASO,ES,Federal Contract Tower,0,0,7,0,7,0,0,174,0,174,0,0,181,0,181,256,0,256,437
12/11/2020,OMN,FL,ASO,ES,Federal Contract Tower,0,0,15,0,15,0,0,156,0,156,0,0,171,0,171,290,0,290,461
12/12/2020,OMN,FL,ASO,ES,Federal Contract Tower,0,0,9,0,9,0,0,30,0,30,0,0,39,0,39,60,0,60,99
12/13/2020,OMN,FL,ASO,ES,Federal Contract Tower,0,0,5,0,5,0,0,39,0,39,0,0,44,0,44,92,0,92,136
12/14/2020,OMN,FL,ASO,ES,Federal Contract Tower,0,0,15,0,15,0,0,83,0,83,0,0,98,0,98,74,0,74,172
12/15/2020,OMN,FL,ASO,ES,Federal Contract Tower,0,0,12,0,12,0,0,161,0,161,0,0,173,0,173,196,0,196,369
12/16/2020,OMN,FL,ASO,ES,Federal Contract Tower,0,0,7,0,7,0,0,58,0,58,0,0,65,0,65,126,0,126,191
12/17/2020,OMN,FL,ASO,ES,Federal Contract Tower,0,0,16,0,16,0,0,33,0,33,0,0,49,0,49,90,0,90,139
12/18/2020,OMN,FL,ASO,ES,Federal Contract Tower,0,0,19,0,19,0,0,166,0,166,0,0,185,0,185,296,0,296,481
12/19/2020,OMN,FL,ASO,ES,Federal Contract Tower,0,0,15,0,15,0,0,94,0,94,0,0,109,0,109,134,0,134,243
12/20/2020,OMN,FL,ASO,ES,Federal Contract Tower,0,0,3,0,3,0,0,33,0,33,0,0,36,0,36,84,0,84,120
12/21/2020,OMN,FL,ASO,ES,Federal Contract Tower,0,0,7,0,7,0,0,44,0,44,0,0,51,0,51,154,0,154,205
12/22/2020,OMN,FL,ASO,ES,Federal Contract Tower,0,0,24,0,24,0,0,114,0,114,0,0,138,0,138,164,0,164,302
12/23/2020,OMN,FL,ASO,ES,Federal Contract Tower,0,0,11,0,11,0,0,117,0,117,0,0,128,0,128,130,0,130,258
12/24/2020,OMN,FL,ASO,ES,Federal Contract Tower,0,0,5,0,5,0,0,63,0,63,0,0,68,0,68,18,0,18,86
12/25/2020,OMN,FL,ASO,ES,Federal Contract Tower,0,0,3,0,3,0,0,1,0,1,0,0,4,0,4,0,0,0,4
12/26/2020,OMN,FL,ASO,ES,Federal Contract Tower,0,0,11,0,11,0,0,43,0,43,0,0,54,0,54,64,0,64,118
12/27/2020,OMN,FL,ASO,ES,Federal Contract Tower,0,0,7,0,7,0,0,32,0,32,0,0,39,0,39,56,0,56,95
12/28/2020,OMN,FL,ASO,ES,Federal Contract Tower,0,0,17,0,17,0,0,54,0,54,0,0,71,0,71,64,0,64,135
12/29/2020,OMN,FL,ASO,ES,Federal Contract Tower,0,0,3,0,3,0,0,89,0,89,0,0,92,0,92,140,0,140,232
12/30/2020,OMN,FL,ASO,ES,Federal Contract Tower,0,0,14,0,14,0,0,72,0,72,0,0,86,0,86,20,0,20,106
12/31/2020,OMN,FL,ASO,ES,Federal Contract Tower,0,0,7,0,7,0,0,62,0,62,0,0,69,0,69,38,0,38,107
01/01/2021,OMN,FL,ASO,ES,Federal Contract Tower,0,0,2,0,2,0,0,9,0,9,0,0,11,0,11,4,0,4,15
01/02/2021,OMN,FL,ASO,ES,Federal Contract Tower,0,0,8,0,8,0,0,30,0,30,0,0,38,0,38,120,0,120,158
01/03/2021,OMN,FL,ASO,ES,Federal Contract Tower,0,0,7,0,7,0,0,7,0,7,0,0,14,0,14,26,0,26,40
01/04/2021,OMN,FL,ASO,ES,Federal Contract Tower,0,0,12,0,12,0,0,117,0,117,0,0,129,0,129,212,0,212,341
01/05/2021,OMN,FL,ASO,ES,Federal Contract Tower,0,0,14,0,14,0,0,148,0,148,0,0,162,0,162,192,0,192,354
01/06/2021,OMN,FL,ASO,ES,Federal Contract Tower,0,0,13,0,13,0,0,214,0,214,0,0,227,0,227,232,0,232,459
01/07/2021,OMN,FL,ASO,ES,Federal Contract Tower,0,0,18,0,18,0,0,131,0,131,0,0,149,0,149,294,0,294,443
01/08/2021,OMN,FL,ASO,ES,Federal Contract Tower,0,0,12,0,12,0,0,157,0,157,0,0,169,0,169,142,0,142,311
01/09/2021,OMN,FL,ASO,ES,Federal Contract Tower,0,0,11,0,11,0,0,120,0,120,0,0,131,0,131,126,0,126,257
01/10/2021,OMN,FL,ASO,ES,Federal Contract Tower,0,0,12,0,12,0,0,54,0,54,0,0,66,0,66,110,0,110,176
01/11/2021,OMN,FL,ASO,ES,Federal Contract Tower,0,0,13,0,13,0,0,121,0,121,0,0,134,0,134,272,0,272,406
01/12/2021,OMN,FL,ASO,ES,Federal Contract Tower,0,0,23,0,23,0,0,86,0,86,0,0,109,0,109,150,0,150,259
01/13/2021,OMN,FL,ASO,ES,Federal Contract Tower,0,0,14,0,14,0,0,176,0,176,0,0,190,0,190,200,0,200,390
01/14/2021,OMN,FL,ASO,ES,Federal Contract Tower,0,0,14,0,14,0,0,151,0,151,0,0,165,0,165,284,0,284,449
01/15/2021,OMN,FL,ASO,ES,Federal Contract Tower,0,0,14,0,14,0,0,103,0,103,0,0,117,0,117,312,0,312,429
01/16/2021,OMN,FL,ASO,ES,Federal Contract Tower,0,0,6,0,6,0,0,59,0,59,0,0,65,0,65,138,0,138,203
01/17/2021,OMN,FL,ASO,ES,Federal Contract Tower,0,0,3,0,3,0,0,29,0,29,0,0,32,0,32,118,0,118,150
01/18/2021,OMN,FL,ASO,ES,Federal Contract Tower,0,0,13,0,13,0,0,146,0,146,0,0,159,0,159,268,0,268,427
01/19/2021,OMN,FL,ASO,ES,Federal Contract Tower,0,0,18,0,18,0,0,144,0,144,0,0,162,0,162,292,0,292,454
01/20/2021,OMN,FL,ASO,ES,Federal Contract Tower,0,0,6,0,6,0,0,185,0,185,0,0,191,0,191,224,0,224,415
01/21/2021,OMN,FL,ASO,ES,Federal Contract Tower,0,0,16,0,16,0,0,179,0,179,0,0,195,0,195,154,0,154,349
01/22/2021,OMN,FL,ASO,ES,Federal Contract Tower,0,0,9,0,9,0,0,151,0,151,0,0,160,0,160,269,0,269,429
01/23/2021,OMN,FL,ASO,ES,Federal Contract Tower,0,0,7,0,7,0,0,5,0,5,0,0,12,0,12,18,0,18,30
01/24/2021,OMN,FL,ASO,ES,Federal Contract Tower,0,0,6,0,6,0,0,17,0,17,0,0,23,0,23,4,0,4,27
01/25/2021,OMN,FL,ASO,ES,Federal Contract Tower,0,0,11,0,11,0,0,133,0,133,0,0,144,0,144,426,0,426,570
01/26/2021,OMN,FL,ASO,ES,Federal Contract Tower,0,0,26,0,26,0,0,113,0,113,0,0,139,0,139,128,0,128,267
01/27/2021,OMN,FL,ASO,ES,Federal Contract Tower,0,0,6,0,6,0,0,58,0,58,0,0,64,0,64,84,0,84,148
01/28/2021,OMN,FL,ASO,ES,Federal Contract Tower,0,0,14,0,14,0,0,121,0,121,0,0,135,0,135,182,0,182,317
01/29/2021,OMN,FL,ASO,ES,Federal Contract Tower,0,0,12,0,12,0,0,130,0,130,0,0,142,0,142,456,0,456,598
01/30/2021,OMN,FL,ASO,ES,Federal Contract Tower,0,0,23,0,23,0,0,105,0,105,0,0,128,0,128,106,0,106,234
01/31/2021,OMN,FL,ASO,ES,Federal Contract Tower,0,0,1,0,1,0,0,72,0,72,0,0,73,0,73,128,0,128,201
02/01/2021,OMN,FL,ASO,ES,Federal Contract Tower,0,0,9,0,9,0,0,37,0,37,0,0,46,0,46,52,0,52,98
02/02/2021,OMN,FL,ASO,ES,Federal Contract Tower,0,0,5,0,5,0,0,38,0,38,0,0,43,0,43,30,0,30,73
02/03/2021,OMN,FL,ASO,ES,Federal Contract Tower,0,0,8,0,8,0,0,185,0,185,0,0,193,0,193,294,0,294,487
02/04/2021,OMN,FL,ASO,ES,Federal Contract Tower,0,0,23,0,23,0,0,186,0,186,0,0,209,0,209,348,0,348,557
02/05/2021,OMN,FL,ASO,ES,Federal Contract Tower,0,0,10,0,10,0,0,94,0,94,0,0,104,0,104,186,0,186,290
02/06/2021,OMN,FL,ASO,ES,Federal Contract Tower,0,0,5,0,5,0,0,37,0,37,0,0,42,0,42,50,0,50,92
02/07/2021,OMN,FL,ASO,ES,Federal Contract Tower,0,0,6,0,6,0,0,15,0,15,0,0,21,0,21,62,0,62,83
02/08/2021,OMN,FL,ASO,ES,Federal Contract Tower,0,0,13,0,13,0,0,120,0,120,0,0,133,0,133,224,0,224,357
02/09/2021,OMN,FL,ASO,ES,Federal Contract Tower,0,0,13,0,13,0,0,77,0,77,0,0,90,0,90,58,0,58,148
02/10/2021,OMN,FL,ASO,ES,Federal Contract Tower,0,0,7,0,7,0,0,47,0,47,0,0,54,0,54,44,0,44,98
02/11/2021,OMN,FL,ASO,ES,Federal Contract Tower,0,0,7,0,7,0,0,178,0,178,0,0,185,0,185,222,0,222,407
02/12/2021,OMN,FL,ASO,ES,Federal Contract Tower,0,0,17,0,17,0,0,90,0,90,0,0,107,0,107,374,0,374,481
02/13/2021,OMN,FL,ASO,ES,Federal Contract Tower,0,0,12,0,12,0,0,31,0,31,0,0,43,0,43,40,0,40,83
02/14/2021,OMN,FL,ASO,ES,Federal Contract Tower,0,0,2,0,2,0,0,10,0,10,0,0,12,0,12,22,0,22,34
02/15/2021,OMN,FL,ASO,ES,Federal Contract Tower,0,0,16,0,16,0,0,100,0,100,0,0,116,0,116,196,0,196,312
02/16/2021,OMN,FL,ASO,ES,Federal Contract Tower,0,0,13,0,13,0,0,167,0,167,0,0,180,0,180,316,0,316,496
02/17/2021,OMN,FL,ASO,ES,Federal Contract Tower,0,0,20,0,20,0,0,123,0,123,0,0,143,0,143,256,0,256,399
02/18/2021,OMN,FL,ASO,ES,Federal Contract Tower,0,0,13,0,13,0,0,117,0,117,0,0,130,0,130,282,0,282,412
02/19/2021,OMN,FL,ASO,ES,Federal Contract Tower,0,0,6,0,6,0,0,4,0,4,0,0,10,0,10,4,0,4,14
02/20/2021,OMN,FL,ASO,ES,Federal Contract Tower,0,0,15,0,15,0,0,179,0,179,0,0,194,0,194,316,0,316,510
02/21/2021,OMN,FL,ASO,ES,Federal Contract Tower,0,0,12,0,12,0,0,50,0,50,0,0,62,0,62,96,0,96,158
02/22/2021,OMN,FL,ASO,ES,Federal Contract Tower,0,0,17,0,17,0,0,183,0,183,0,0,200,0,200,384,0,384,584
02/23/2021,OMN,FL,ASO,ES,Federal Contract Tower,0,0,18,0,18,0,0,181,0,181,0,0,199,0,199,426,0,426,625
02/24/2021,OMN,FL,ASO,ES,Federal Contract Tower,0,0,20,0,20,0,0,217,0,217,0,0,237,0,237,348,0,348,585
02/25/2021,OMN,FL,ASO,ES,Federal Contract Tower,0,0,9,0,9,0,0,167,0,167,0,0,176,0,176,402,0,402,578
02/26/2021,OMN,FL,ASO,ES,Federal Contract Tower,0,0,16,0,16,0,0,124,0,124,0,0,140,0,140,402,0,402,542
02/27/2021,OMN,FL,ASO,ES,Federal Contract Tower,0,0,15,0,15,0,0,165,0,165,0,0,180,0,180,194,0,194,374
02/28/2021,OMN,FL,ASO,ES,Federal Contract Tower,0,0,16,0,16,0,0,109,0,109,0,0,125,0,125,242,0,242,367
03/01/2021,OMN,FL,ASO,ES,Federal Contract Tower,0,0,13,0,13,0,0,123,0,123,0,0,136,0,136,366,0,366,502
03/02/2021,OMN,FL,ASO,ES,Federal Contract Tower,0,0,18,0,18,0,0,3,0,3,0,0,21,0,21,58,0,58,79
03/03/2021,OMN,FL,ASO,ES,Federal Contract Tower,0,0,7,0,7,0,0,42,0,42,0,0,49,0,49,134,0,134,183
03/04/2021,OMN,FL,ASO,ES,Federal Contract Tower,0,0,8,0,8,0,0,195,0,195,0,0,203,0,203,274,0,274,477
03/05/2021,OMN,FL,ASO,ES,Federal Contract Tower,0,0,7,0,7,0,0,120,0,120,0,0,127,0,127,418,0,418,545
03/06/2021,OMN,FL,ASO,ES,Federal Contract Tower,0,0,6,0,6,0,0,68,0,68,0,0,74,0,74,72,0,72,146
03/07/2021,OMN,FL,ASO,ES,Federal Contract Tower,0,0,6,0,6,0,0,6,0,6,0,0,12,0,12,8,0,8,20
03/08/2021,OMN,FL,ASO,ES,Federal Contract Tower,0,0,15,0,15,0,0,77,0,77,0,0,92,0,92,230,0,230,322
03/09/2021,OMN,FL,ASO,ES,Federal Contract Tower,0,2,13,0,15,0,0,175,0,175,0,2,188,0,190,468,0,468,658
03/10/2021,OMN,FL,ASO,ES,Federal Contract Tower,0,0,14,0,14,0,0,171,0,171,0,0,185,0,185,386,0,386,571
03/11/2021,OMN,FL,ASO,ES,Federal Contract Tower,0,0,11,0,11,0,0,187,0,187,0,0,198,0,198,402,0,402,600
03/12/2021,OMN,FL,ASO,ES,Federal Contract Tower,0,0,13,0,13,0,0,183,0,183,0,0,196,0,196,522,0,522,718
03/13/2021,OMN,FL,ASO,ES,Federal Contract Tower,0,0,22,0,22,0,0,152,0,152,0,0,174,0,174,298,0,298,472
03/14/2021,OMN,FL,ASO,ES,Federal Contract Tower,0,0,4,0,4,0,0,104,0,104,0,0,108,0,108,176,0,176,284
03/15/2021,OMN,FL,ASO,ES,Federal Contract Tower,0,0,12,0,12,0,0,176,0,176,0,0,188,0,188,548,0,548,736
03/16/2021,OMN,FL,ASO,ES,Federal Contract Tower,0,0,11,0,11,0,0,205,0,205,0,0,216,0,216,358,0,358,574
03/17/2021,OMN,FL,ASO,ES,Federal Contract Tower,0,0,20,0,20,0,0,170,0,170,0,0,190,0,190,314,0,314,504
03/18/2021,OMN,FL,ASO,ES,Federal Contract Tower,0,0,4,0,4,0,0,72,0,72,0,0,76,0,76,98,0,98,174
03/19/2021,OMN,FL,ASO,ES,Federal Contract Tower,0,0,12,0,12,0,0,184,0,184,0,0,196,0,196,420,0,420,616
03/20/2021,OMN,FL,ASO,ES,Federal Contract Tower,0,0,8,0,8,0,0,0,0,0,0,0,8,0,8,0,0,0,8
03/21/2021,OMN,FL,ASO,ES,Federal Contract Tower,0,0,4,0,4,0,0,0,0,0,0,0,4,0,4,0,0,0,4
03/22/2021,OMN,FL,ASO,ES,Federal Contract Tower,0,0,10,0,10,0,0,1,0,1,0,0,11,0,11,4,0,4,15
03/23/2021,OMN,FL,ASO,ES,Federal Contract Tower,0,0,16,0,16,0,0,160,0,160,0,0,176,0,176,270,0,270,446
03/24/2021,OMN,FL,ASO,ES,Federal Contract Tower,0,0,13,0,13,0,0,224,0,224,0,0,237,0,237,284,0,284,521
03/25/2021,OMN,FL,ASO,ES,Federal Contract Tower,0,0,8,0,8,0,0,110,0,110,0,0,118,0,118,258,0,258,376
03/26/2021,OMN,FL,ASO,ES,Federal Contract Tower,0,0,13,0,13,0,0,117,0,117,0,0,130,0,130,332,0,332,462
03/27/2021,OMN,FL,ASO,ES,Federal Contract Tower,0,0,17,0,17,0,0,149,0,149,0,0,166,0,166,217,0,217,383
03/28/2021,OMN,FL,ASO,ES,Federal Contract Tower,0,0,6,0,6,0,0,42,0,42,0,0,48,0,48,86,0,86,134
03/29/2021,OMN,FL,ASO,ES,Federal Contract Tower,0,0,11,0,11,0,0,126,0,126,0,0,137,0,137,340,0,340,477
03/30/2021,OMN,FL,ASO,ES,Federal Contract Tower,0,0,20,0,20,0,0,153,0,153,0,0,173,0,173,316,0,316,489
03/31/2021,OMN,FL,ASO,ES,Federal Contract Tower,0,0,13,0,13,0,0,128,0,128,0,0,141,0,141,210,0,210,351
04/01/2021,OMN,FL,ASO,ES,Federal Contract Tower,0,0,7,0,7,0,0,90,0,90,0,0,97,0,97,304,0,304,401
04/02/2021,OMN,FL,ASO,ES,Federal Contract Tower,0,0,10,0,10,0,0,53,0,53,0,0,63,0,63,44,0,44,107
04/03/2021,OMN,FL,ASO,ES,Federal Contract Tower,0,0,6,0,6,0,0,76,0,76,0,0,82,0,82,126,0,126,208
04/04/2021,OMN,FL,ASO,ES,Federal Contract Tower,0,0,9,0,9,0,0,67,0,67,0,0,76,0,76,209,0,209,285
04/05/2021,OMN,FL,ASO,ES,Federal Contract Tower,0,0,16,0,16,0,0,145,0,145,0,0,161,0,161,362,0,362,523
04/06/2021,OMN,FL,ASO,ES,Federal Contract Tower,0,0,20,0,20,0,0,143,0,143,0,0,163,0,163,282,0,282,445
04/07/2021,OMN,FL,ASO,ES,Federal Contract Tower,0,0,13,0,13,0,0,161,0,161,0,0,174,0,174,242,0,242,416
04/08/2021,OMN,FL,ASO,ES,Federal Contract Tower,0,0,14,0,14,0,0,207,0,207,0,0,221,0,221,460,0,460,681
04/09/2021,OMN,FL,ASO,ES,Federal Contract Tower,0,0,11,0,11,0,0,159,0,159,0,0,170,0,170,348,0,348,518
04/10/2021,OMN,FL,ASO,ES,Federal Contract Tower,0,0,3,0,3,0,0,41,0,41,0,0,44,0,44,86,0,86,130
04/11/2021,OMN,FL,ASO,ES,Federal Contract Tower,0,0,4,0,4,0,0,2,0,2,0,0,6,0,6,0,0,0,6
04/12/2021,OMN,FL,ASO,ES,Federal Contract Tower,0,0,12,0,12,0,0,113,0,113,0,0,125,0,125,316,0,316,441
04/13/2021,OMN,FL,ASO,ES,Federal Contract Tower,0,0,12,0,12,0,0,188,0,188,0,0,200,0,200,324,0,324,524
04/14/2021,OMN,FL,ASO,ES,Federal Contract Tower,0,0,15,0,15,0,0,188,0,188,0,0,203,0,203,280,0,280,483
04/15/2021,OMN,FL,ASO,ES,Federal Contract Tower,0,0,13,0,13,0,0,144,0,144,0,0,157,0,157,222,0,222,379
04/16/2021,OMN,FL,ASO,ES,Federal Contract Tower,0,0,9,0,9,0,0,108,0,108,0,0,117,0,117,244,0,244,361
04/17/2021,OMN,FL,ASO,ES,Federal Contract Tower,0,0,10,0,10,0,0,0,0,0,0,0,10,0,10,10,0,10,20
04/18/2021,OMN,FL,ASO,ES,Federal Contract Tower,0,0,2,0,2,0,0,33,0,33,0,0,35,0,35,24,0,24,59
04/19/2021,OMN,FL,ASO,ES,Federal Contract Tower,0,0,6,0,6,0,0,22,0,22,0,0,28,0,28,24,0,24,52
04/20/2021,OMN,FL,ASO,ES,Federal Contract Tower,0,0,1,0,1,0,0,26,0,26,0,0,27,0,27,76,0,76,103
04/21/2021,OMN,FL,ASO,ES,Federal Contract Tower,0,1,12,0,13,0,0,176,0,176,0,1,188,0,189,222,0,222,411
04/22/2021,OMN,FL,ASO,ES,Federal Contract Tower,0,0,18,0,18,0,0,132,0,132,0,0,150,0,150,276,0,276,426
04/23/2021,OMN,FL,ASO,ES,Federal Contract Tower,0,0,13,0,13,0,0,143,0,143,0,0,156,0,156,308,0,308,464
04/24/2021,OMN,FL,ASO,ES,Federal Contract Tower,0,0,9,0,9,0,0,76,0,76,0,0,85,0,85,226,0,226,311
04/25/2021,OMN,FL,ASO,ES,Federal Contract Tower,0,0,1,0,1,0,0,15,0,15,0,0,16,0,16,60,0,60,76
04/26/2021,OMN,FL,ASO,ES,Federal Contract Tower,0,0,15,0,15,0,0,128,0,128,0,0,143,0,143,238,0,238,381
04/27/2021,OMN,FL,ASO,ES,Federal Contract Tower,0,0,24,0,24,0,0,103,0,103,0,0,127,0,127,216,0,216,343
04/28/2021,OMN,FL,ASO,ES,Federal Contract Tower,0,0,11,0,11,0,0,156,0,156,0,0,167,0,167,168,0,168,335
04/29/2021,OMN,FL,ASO,ES,Federal Contract Tower,0,0,16,0,16,0,0,193,0,193,0,0,209,0,209,378,0,378,587
04/30/2021,OMN,FL,ASO,ES,Federal Contract Tower,0,0,19,0,19,0,0,149,0,149,0,0,168,0,168,324,0,324,492
05/01/2021,OMN,FL,ASO,ES,Federal Contract Tower,0,0,7,0,7,0,0,109,0,109,0,0,116,0,116,156,0,156,272
05/02/2021,OMN,FL,ASO,ES,Federal Contract Tower,0,0,5,0,5,0,0,43,0,43,0,0,48,0,48,146,0,146,194
05/03/2021,OMN,FL,ASO,ES,Federal Contract Tower,0,0,10,0,10,0,0,118,0,118,0,0,128,0,128,306,0,306,434
05/04/2021,OMN,FL,ASO,ES,Federal Contract Tower,0,0,18,0,18,0,0,142,0,142,0,0,160,0,160,368,0,368,528
05/05/2021,OMN,FL,ASO,ES,Federal Contract Tower,0,0,14,0,14,0,0,132,0,132,0,0,146,0,146,244,0,244,390
05/06/2021,OMN,FL,ASO,ES,Federal Contract Tower,0,0,4,0,4,0,0,54,0,54,0,0,58,0,58,94,0,94,152
05/07/2021,OMN,FL,ASO,ES,Federal Contract Tower,0,0,6,0,6,0,0,153,0,153,0,0,159,0,159,316,0,316,475
05/08/2021,OMN,FL,ASO,ES,Federal Contract Tower,0,0,9,0,9,0,0,116,0,116,0,0,125,0,125,182,0,182,307
05/09/2021,OMN,FL,ASO,ES,Federal Contract Tower,0,0,6,0,6,0,0,83,0,83,0,0,89,0,89,152,0,152,241
05/10/2021,OMN,FL,ASO,ES,Federal Contract Tower,0,0,13,0,13,0,0,104,0,104,0,0,117,0,117,276,0,276,393
05/11/2021,OMN,FL,ASO,ES,Federal Contract Tower,0,0,5,0,5,0,0,91,0,91,0,0,96,0,96,208,0,208,304
05/12/2021,OMN,FL,ASO,ES,Federal Contract Tower,0,0,10,0,10,0,0,131,0,131,0,0,141,0,141,184,0,184,325
05/13/2021,OMN,FL,ASO,ES,Federal Contract Tower,0,3,23,0,26,0,0,10,0,10,0,3,33,0,36,14,0,14,50
05/14/2021,OMN,FL,ASO,ES,Federal Contract Tower,0,0,18,0,18,0,0,90,0,90,0,0,108,0,108,100,0,100,208
05/15/2021,OMN,FL,ASO,ES,Federal Contract Tower,0,0,16,0,16,0,0,58,0,58,0,0,74,0,74,46,0,46,120
05/16/2021,OMN,FL,ASO,ES,Federal Contract Tower,0,0,10,0,10,0,0,74,0,74,0,0,84,0,84,184,0,184,268
05/17/2021,OMN,FL,ASO,ES,Federal Contract Tower,0,0,20,0,20,0,0,116,0,116,0,0,136,0,136,340,0,340,476
05/18/2021,OMN,FL,ASO,ES,Federal Contract Tower,0,0,17,0,17,0,0,102,0,102,0,0,119,0,119,172,0,172,291
05/19/2021,OMN,FL,ASO,ES,Federal Contract Tower,0,0,22,0,22,0,0,76,0,76,0,0,98,0,98,84,0,84,182
05/20/2021,OMN,FL,ASO,ES,Federal Contract Tower,0,0,12,0,12,0,0,63,0,63,0,0,75,0,75,108,0,108,183
05/21/2021,OMN,FL,ASO,ES,Federal Contract Tower,0,0,17,0,17,0,0,94,0,94,0,0,111,0,111,168,0,168,279
05/22/2021,OMN,FL,ASO,ES,Federal Contract Tower,0,0,7,0,7,0,0,74,0,74,0,0,81,0,81,100,0,100,181
05/23/2021,OMN,FL,ASO,ES,Federal Contract Tower,0,0,9,0,9,0,0,60,0,60,0,0,69,0,69,90,0,90,159
05/24/2021,OMN,FL,ASO,ES,Federal Contract Tower,0,0,13,0,13,0,0,135,0,135,0,0,148,0,148,256,0,256,404
05/25/2021,OMN,FL,ASO,ES,Federal Contract Tower,0,0,10,0,10,0,0,131,0,131,0,0,141,0,141,326,0,326,467
05/26/2021,OMN,FL,ASO,ES,Federal Contract Tower,0,0,14,0,14,0,0,177,0,177,0,0,191,0,191,338,0,338,529
05/27/2021,OMN,FL,ASO,ES,Federal Contract Tower,0,0,12,0,12,0,0,158,0,158,0,0,170,0,170,252,0,252,422
05/28/2021,OMN,FL,ASO,ES,Federal Contract Tower,0,0,16,0,16,0,0,140,0,140,0,0,156,0,156,314,0,314,470
05/29/2021,OMN,FL,ASO,ES,Federal Contract Tower,0,0,8,0,8,0,0,104,0,104,0,0,112,0,112,218,0,218,330
05/30/2021,OMN,FL,ASO,ES,Federal Contract Tower,0,0,5,0,5,0,0,67,0,67,0,0,72,0,72,136,0,136,208
05/31/2021,OMN,FL,ASO,ES,Federal Contract Tower,0,0,23,0,23,0,0,95,0,95,0,0,118,0,118,170,0,170,288
06/01/2021,OMN,FL,ASO,ES,Federal Contract Tower,0,0,16,0,16,0,0,123,0,123,0,0,139,0,139,282,0,282,421
06/02/2021,OMN,FL,ASO,ES,Federal Contract Tower,0,0,10,0,10,0,0,89,0,89,0,0,99,0,99,78,0,78,177
06/03/2021,OMN,FL,ASO,ES,Federal Contract Tower,0,0,14,0,14,0,0,142,0,142,0,0,156,0,156,288,0,288,444
06/04/2021,OMN,FL,ASO,ES,Federal Contract Tower,0,0,10,0,10,0,0,62,0,62,0,0,72,0,72,186,0,186,258
06/05/2021,OMN,FL,ASO,ES,Federal Contract Tower,0,0,15,0,15,0,0,88,0,88,0,0,103,0,103,152,0,152,255
06/06/2021,OMN,FL,ASO,ES,Federal Contract Tower,0,0,10,0,10,0,0,119,0,119,0,0,129,0,129,266,0,266,395
06/07/2021,OMN,FL,ASO,ES,Federal Contract Tower,0,0,19,0,19,0,0,144,0,144,0,0,163,0,163,414,0,414,577
06/08/2021,OMN,FL,ASO,ES,Federal Contract Tower,0,0,9,0,9,0,0,122,0,122,0,0,131,0,131,286,0,286,417
06/09/2021,OMN,FL,ASO,ES,Federal Contract Tower,0,0,7,0,7,0,0,155,0,155,0,0,162,0,162,306,0,306,468
06/10/2021,OMN,FL,ASO,ES,Federal Contract Tower,0,0,16,0,16,0,0,162,0,162,0,0,178,0,178,346,0,346,524
06/11/2021,OMN,FL,ASO,ES,Federal Contract Tower,0,0,9,0,9,0,0,138,0,138,0,0,147,0,147,302,0,302,449
06/12/2021,OMN,FL,ASO,ES,Federal Contract Tower,0,0,6,0,6,0,0,122,0,122,0,0,128,0,128,136,0,136,264
06/13/2021,OMN,FL,ASO,ES,Federal Contract Tower,0,0,3,0,3,0,0,40,0,40,0,0,43,0,43,54,0,54,97
06/14/2021,OMN,FL,ASO,ES,Federal Contract Tower,0,0,6,0,6,0,0,65,0,65,0,0,71,0,71,106,0,106,177
06/15/2021,OMN,FL,ASO,ES,Federal Contract Tower,0,0,7,0,7,0,0,79,0,79,0,0,86,0,86,142,0,142,228
06/16/2021,OMN,FL,ASO,ES,Federal Contract Tower,0,0,16,0,16,0,0,197,0,197,0,0,213,0,213,138,0,138,351
06/17/2021,OMN,FL,ASO,ES,Federal Contract Tower,0,0,15,0,15,0,0,165,0,165,0,0,180,0,180,288,0,288,468
06/18/2021,OMN,FL,ASO,ES,Federal Contract Tower,0,0,11,0,11,0,0,66,0,66,0,0,77,0,77,178,0,178,255
06/19/2021,OMN,FL,ASO,ES,Federal Contract Tower,0,0,14,0,14,0,0,87,0,87,0,0,101,0,101,120,0,120,221
06/20/2021,OMN,FL,ASO,ES,Federal Contract Tower,0,0,6,0,6,0,0,11,0,11,0,0,17,0,17,34,0,34,51
06/21/2021,OMN,FL,ASO,ES,Federal Contract Tower,0,0,11,0,11,0,0,78,0,78,0,0,89,0,89,154,0,154,243
06/22/2021,OMN,FL,ASO,ES,Federal Contract Tower,0,0,3,0,3,0,0,70,0,70,0,0,73,0,73,200,0,200,273
06/23/2021,OMN,FL,ASO,ES,Federal Contract Tower,0,0,13,0,13,0,0,131,0,131,0,0,144,0,144,152,0,152,296
06/24/2021,OMN,FL,ASO,ES,Federal Contract Tower,0,0,10,0,10,0,0,41,0,41,0,0,51,0,51,72,0,72,123
06/25/2021,OMN,FL,ASO,ES,Federal Contract Tower,0,0,9,0,9,0,0,79,0,79,0,0,88,0,88,62,0,62,150
06/26/2021,OMN,FL,ASO,ES,Federal Contract Tower,0,0,11,0,11,0,0,74,0,74,0,0,85,0,85,98,0,98,183
06/27/2021,OMN,FL,ASO,ES,Federal Contract Tower,0,0,11,0,11,0,0,50,0,50,0,0,61,0,61,50,0,50,111
06/28/2021,OMN,FL,ASO,ES,Federal Contract Tower,0,0,20,0,20,0,0,107,0,107,0,0,127,0,127,326,0,326,453
06/29/2021,OMN,FL,ASO,ES,Federal Contract Tower,0,0,19,0,19,0,0,104,0,104,0,0,123,0,123,163,0,163,286
06/30/2021,OMN,FL,ASO,ES,Federal Contract Tower,0,0,19,0,19,0,0,111,0,111,0,0,130,0,130,118,0,118,248
07/01/2021,OMN,FL,ASO,ES,Federal Contract Tower,0,0,17,0,17,0,0,71,0,71,0,0,88,0,88,74,0,74,162
07/02/2021,OMN,FL,ASO,ES,Federal Contract Tower,0,0,22,0,22,0,0,74,0,74,0,0,96,0,96,126,0,126,222
07/03/2021,OMN,FL,ASO,ES,Federal Contract Tower,0,0,22,0,22,0,0,9,0,9,0,0,31,0,31,22,0,22,53
07/04/2021,OMN,FL,ASO,ES,Federal Contract Tower,0,0,1,0,1,0,0,3,0,3,0,0,4,0,4,0,0,0,4
07/05/2021,OMN,FL,ASO,ES,Federal Contract Tower,0,0,17,0,17,0,0,95,0,95,0,0,112,0,112,124,0,124,236
07/06/2021,OMN,FL,ASO,ES,Federal Contract Tower,0,0,17,0,17,0,0,58,0,58,0,0,75,0,75,80,0,80,155
07/07/2021,OMN,FL,ASO,ES,Federal Contract Tower,0,0,1,0,1,0,0,0,0,0,0,0,1,0,1,0,0,0,1
07/08/2021,OMN,FL,ASO,ES,Federal Contract Tower,0,0,7,0,7,0,0,25,0,25,0,0,32,0,32,8,0,8,40
07/09/2021,OMN,FL,ASO,ES,Federal Contract Tower,0,0,16,0,16,0,0,111,0,111,0,0,127,0,127,192,0,192,319
07/10/2021,OMN,FL,ASO,ES,Federal Contract Tower,0,0,12,0,12,0,0,71,0,71,0,0,83,0,83,108,0,108,191
07/11/2021,OMN,FL,ASO,ES,Federal Contract Tower,0,0,6,0,6,0,0,55,0,55,0,0,61,0,61,80,0,80,141
07/12/2021,OMN,FL,ASO,ES,Federal Contract Tower,0,0,16,0,16,0,0,76,0,76,0,0,92,0,92,98,0,98,190
07/13/2021,OMN,FL,ASO,ES,Federal Contract Tower,0,0,15,0,15,0,0,161,0,161,0,0,176,0,176,104,0,104,280
07/14/2021,OMN,FL,ASO,ES,Federal Contract Tower,0,0,19,0,19,0,0,142,0,142,0,0,161,0,161,146,0,146,307
07/15/2021,OMN,FL,ASO,ES,Federal Contract Tower,0,0,32,0,32,0,0,132,0,132,0,0,164,0,164,192,0,192,356
07/16/2021,OMN,FL,ASO,ES,Federal Contract Tower,0,0,20,0,20,0,0,134,0,134,0,0,154,0,154,274,0,274,428
07/17/2021,OMN,FL,ASO,ES,Federal Contract Tower,0,0,11,0,11,0,0,125,0,125,0,0,136,0,136,196,0,196,332
07/18/2021,OMN,FL,ASO,ES,Federal Contract Tower,0,0,12,0,12,0,0,57,0,57,0,0,69,0,69,82,0,82,151
07/19/2021,OMN,FL,ASO,ES,Federal Contract Tower,0,0,6,0,6,0,0,119,0,119,0,0,125,0,125,178,0,178,303
07/20/2021,OMN,FL,ASO,ES,Federal Contract Tower,0,0,6,0,6,0,0,117,0,117,0,0,123,0,123,166,0,166,289
07/21/2021,OMN,FL,ASO,ES,Federal Contract Tower,0,0,22,0,22,0,0,142,0,142,0,0,164,0,164,262,0,262,426
07/22/2021,OMN,FL,ASO,ES,Federal Contract Tower,0,0,14,0,14,0,0,117,0,117,0,0,131,0,131,288,0,288,419
07/23/2021,OMN,FL,ASO,ES,Federal Contract Tower,0,0,17,0,17,0,0,54,0,54,0,0,71,0,71,78,0,78,149
07/24/2021,OMN,FL,ASO,ES,Federal Contract Tower,0,0,21,0,21,0,0,123,0,123,0,0,144,0,144,202,0,202,346
07/25/2021,OMN,FL,ASO,ES,Federal Contract Tower,0,0,10,0,10,0,0,40,0,40,0,0,50,0,50,96,0,96,146
07/26/2021,OMN,FL,ASO,ES,Federal Contract Tower,0,0,15,0,15,0,0,112,0,112,0,0,127,0,127,176,0,176,303
07/27/2021,OMN,FL,ASO,ES,Federal Contract Tower,0,0,5,0,5,0,0,114,0,114,0,0,119,0,119,200,0,200,319
07/28/2021,OMN,FL,ASO,ES,Federal Contract Tower,0,0,14,0,14,0,0,104,0,104,0,0,118,0,118,110,0,110,228
07/29/2021,OMN,FL,ASO,ES,Federal Contract Tower,0,0,7,0,7,0,0,105,0,105,0,0,112,0,112,106,0,106,218
07/30/2021,OMN,FL,ASO,ES,Federal Contract Tower,0,0,14,0,14,0,0,72,0,72,0,0,86,0,86,74,0,74,160
07/31/2021,OMN,FL,ASO,ES,Federal Contract Tower,0,0,14,0,14,0,0,91,0,91,0,0,105,0,105,134,0,134,239
08/01/2021,OMN,FL,ASO,ES,Federal Contract Tower,0,0,5,0,5,0,0,69,0,69,0,0,74,0,74,146,0,146,220
08/02/2021,OMN,FL,ASO,ES,Federal Contract Tower,0,0,10,0,10,0,0,46,0,46,0,0,56,0,56,130,0,130,186
08/03/2021,OMN,FL,ASO,ES,Federal Contract Tower,0,0,8,0,8,0,0,56,0,56,0,0,64,0,64,56,0,56,120
08/04/2021,OMN,FL,ASO,ES,Federal Contract Tower,0,0,15,0,15,0,0,10,0,10,0,0,25,0,25,10,0,10,35
08/05/2021,OMN,FL,ASO,ES,Federal Contract Tower,0,0,7,0,7,0,0,95,0,95,0,0,102,0,102,130,0,130,232
08/06/2021,OMN,FL,ASO,ES,Federal Contract Tower,0,0,14,0,14,0,0,139,0,139,0,0,153,0,153,224,0,224,377
08/07/2021,OMN,FL,ASO,ES,Federal Contract Tower,0,0,16,0,16,0,0,102,0,102,0,0,118,0,118,80,0,80,198
08/08/2021,OMN,FL,ASO,ES,Federal Contract Tower,0,0,12,0,12,0,0,47,0,47,0,0,59,0,59,58,0,58,117
08/09/2021,OMN,FL,ASO,ES,Federal Contract Tower,0,0,8,0,8,0,0,91,0,91,0,0,99,0,99,222,0,222,321
08/10/2021,OMN,FL,ASO,ES,Federal Contract Tower,0,0,9,0,9,0,0,89,0,89,0,0,98,0,98,192,0,192,290
08/11/2021,OMN,FL,ASO,ES,Federal Contract Tower,0,0,16,0,16,0,0,145,0,145,0,0,161,0,161,76,0,76,237
08/12/2021,OMN,FL,ASO,ES,Federal Contract Tower,0,0,8,0,8,0,0,138,0,138,0,0,146,0,146,166,0,166,312
08/13/2021,OMN,FL,ASO,ES,Federal Contract Tower,0,0,11,0,11,0,0,65,0,65,0,0,76,0,76,102,0,102,178
08/14/2021,OMN,FL,ASO,ES,Federal Contract Tower,0,0,3,0,3,0,0,39,0,39,0,0,42,0,42,40,0,40,82
08/15/2021,OMN,FL,ASO,ES,Federal Contract Tower,0,0,6,0,6,0,0,25,0,25,0,0,31,0,31,54,0,54,85
08/16/2021,OMN,FL,ASO,ES,Federal Contract Tower,0,0,14,0,14,0,0,59,0,59,0,0,73,0,73,98,0,98,171
08/17/2021,OMN,FL,ASO,ES,Federal Contract Tower,0,0,17,0,17,0,0,93,0,93,0,0,110,0,110,196,0,196,306
08/18/2021,OMN,FL,ASO,ES,Federal Contract Tower,0,0,12,0,12,0,0,98,0,98,0,0,110,0,110,132,0,132,242
08/19/2021,OMN,FL,ASO,ES,Federal Contract Tower,0,0,16,0,16,0,0,76,0,76,0,0,92,0,92,116,0,116,208
08/20/2021,OMN,FL,ASO,ES,Federal Contract Tower,0,0,16,0,16,0,0,126,0,126,0,0,142,0,142,216,0,216,358
08/21/2021,OMN,FL,ASO,ES,Federal Contract Tower,0,0,5,0,5,0,0,122,0,122,0,0,127,0,127,64,0,64,191
08/22/2021,OMN,FL,ASO,ES,Federal Contract Tower,0,0,16,0,16,0,0,50,0,50,0,0,66,0,66,34,0,34,100
08/23/2021,OMN,FL,ASO,ES,Federal Contract Tower,0,0,13,0,13,0,0,110,0,110,0,0,123,0,123,256,0,256,379
08/24/2021,OMN,FL,ASO,ES,Federal Contract Tower,0,0,11,0,11,0,0,73,0,73,0,0,84,0,84,170,0,170,254
08/25/2021,OMN,FL,ASO,ES,Federal Contract Tower,0,0,16,0,16,0,0,150,0,150,0,0,166,0,166,150,0,150,316
08/26/2021,OMN,FL,ASO,ES,Federal Contract Tower,0,0,11,0,11,0,0,53,0,53,0,0,64,0,64,54,0,54,118
08/27/2021,OMN,FL,ASO,ES,Federal Contract Tower,0,0,3,0,3,0,0,11,0,11,0,0,14,0,14,48,0,48,62
08/28/2021,OMN,FL,ASO,ES,Federal Contract Tower,0,0,13,0,13,0,0,46,0,46,0,0,59,0,59,56,0,56,115
08/29/2021,OMN,FL,ASO,ES,Federal Contract Tower,0,0,3,0,3,0,0,26,0,26,0,0,29,0,29,42,0,42,71
08/30/2021,OMN,FL,ASO,ES,Federal Contract Tower,0,0,13,0,13,0,0,91,0,91,0,0,104,0,104,168,0,168,272
08/31/2021,OMN,FL,ASO,ES,Federal Contract Tower,0,0,10,0,10,0,0,76,0,76,0,0,86,0,86,138,0,138,224
09/01/2021,OMN,FL,ASO,ES,Federal Contract Tower,0,0,4,0,4,0,0,29,0,29,0,0,33,0,33,54,0,54,87
09/02/2021,OMN,FL,ASO,ES,Federal Contract Tower,0,0,12,0,12,0,0,86,0,86,0,0,98,0,98,104,0,104,202
09/03/2021,OMN,FL,ASO,ES,Federal Contract Tower,0,0,10,0,10,0,0,108,0,108,0,0,118,0,118,126,0,126,244
09/04/2021,OMN,FL,ASO,ES,Federal Contract Tower,0,0,3,0,3,0,0,86,0,86,0,0,89,0,89,72,0,72,161
09/05/2021,OMN,FL,ASO,ES,Federal Contract Tower,0,0,4,0,4,0,0,26,0,26,0,0,30,0,30,24,0,24,54
09/06/2021,OMN,FL,ASO,ES,Federal Contract Tower,0,0,15,0,15,0,0,123,0,123,0,0,138,0,138,186,0,186,324
09/07/2021,OMN,FL,ASO,ES,Federal Contract Tower,0,0,8,0,8,0,0,115,0,115,0,0,123,0,123,158,0,158,281
09/08/2021,OMN,FL,ASO,ES,Federal Contract Tower,0,0,15,0,15,0,0,177,0,177,0,0,192,0,192,148,0,148,340
09/09/2021,OMN,FL,ASO,ES,Federal Contract Tower,0,0,14,0,14,0,0,34,0,34,0,0,48,0,48,12,0,12,60
09/10/2021,OMN,FL,ASO,ES,Federal Contract Tower,0,0,14,0,14,0,0,56,0,56,0,0,70,0,70,98,0,98,168
09/11/2021,OMN,FL,ASO,ES,Federal Contract Tower,0,0,7,0,7,0,0,33,0,33,0,0,40,0,40,92,0,92,132
09/12/2021,OMN,FL,ASO,ES,Federal Contract Tower,0,0,7,0,7,0,0,42,0,42,0,0,49,0,49,48,0,48,97
09/13/2021,OMN,FL,ASO,ES,Federal Contract Tower,0,0,8,0,8,0,0,100,0,100,0,0,108,0,108,220,0,220,328
09/14/2021,OMN,FL,ASO,ES,Federal Contract Tower,0,0,10,0,10,0,0,122,0,122,0,0,132,0,132,202,0,202,334
09/15/2021,OMN,FL,ASO,ES,Federal Contract Tower,0,0,10,0,10,0,0,98,0,98,0,0,108,0,108,160,0,160,268
09/16/2021,OMN,FL,ASO,ES,Federal Contract Tower,0,0,11,0,11,0,0,134,0,134,0,0,145,0,145,176,0,176,321
09/17/2021,OMN,FL,ASO,ES,Federal Contract Tower,0,0,12,0,12,0,0,91,0,91,0,0,103,0,103,82,0,82,185
09/18/2021,OMN,FL,ASO,ES,Federal Contract Tower,0,0,10,0,10,0,0,55,0,55,0,0,65,0,65,36,0,36,101
09/19/2021,OMN,FL,ASO,ES,Federal Contract Tower,0,0,1,0,1,0,0,29,0,29,0,0,30,0,30,54,0,54,84
09/20/2021,OMN,FL,ASO,ES,Federal Contract Tower,0,0,7,0,7,0,0,56,0,56,0,0,63,0,63,108,0,108,171
09/21/2021,OMN,FL,ASO,ES,Federal Contract Tower,0,0,14,0,14,0,0,135,0,135,0,0,149,0,149,214,0,214,363
09/22/2021,OMN,FL,ASO,ES,Federal Contract Tower,0,0,19,0,19,0,0,118,0,118,0,0,137,0,137,184,0,184,321
09/23/2021,OMN,FL,ASO,ES,Federal Contract Tower,0,0,8,0,8,0,0,185,0,185,0,0,193,0,193,146,0,146,339
09/24/2021,OMN,FL,ASO,ES,Federal Contract Tower,0,0,13,0,13,0,0,133,0,133,0,0,146,0,146,240,0,240,386
09/25/2021,OMN,FL,ASO,ES,Federal Contract Tower,0,0,13,0,13,0,0,119,0,119,0,0,132,0,132,132,0,132,264
09/26/2021,OMN,FL,ASO,ES,Federal Contract Tower,0,0,4,0,4,0,0,28,0,28,0,0,32,0,32,16,0,16,48
09/27/2021,OMN,FL,ASO,ES,Federal Contract Tower,0,0,9,0,9,0,0,107,0,107,0,0,116,0,116,301,0,301,417
09/28/2021,OMN,FL,ASO,ES,Federal Contract Tower,0,0,9,0,9,0,0,116,0,116,0,0,125,0,125,242,0,242,367
09/29/2021,OMN,FL,ASO,ES,Federal Contract Tower,0,0,12,0,12,0,0,140,0,140,0,0,152,0,152,348,0,348,500
09/30/2021,OMN,FL,ASO,ES,Federal Contract Tower,0,0,5,0,5,0,0,162,0,162,0,0,167,0,167,294,0,294,461
10/01/2021,OMN,FL,ASO,ES,Federal Contract Tower,0,0,8,0,8,0,0,53,0,53,0,0,61,0,61,148,0,148,209
10/02/2021,OMN,FL,ASO,ES,Federal Contract Tower,0,0,9,0,9,0,0,98,0,98,0,0,107,0,107,158,0,158,265
10/03/2021,OMN,FL,ASO,ES,Federal Contract Tower,0,0,9,0,9,0,0,30,0,30,0,0,39,0,39,32,0,32,71
10/04/2021,OMN,FL,ASO,ES,Federal Contract Tower,0,0,16,0,16,0,0,120,0,120,0,0,136,0,136,260,0,260,396
10/05/2021,OMN,FL,ASO,ES,Federal Contract Tower,0,0,9,0,9,0,0,128,0,128,0,0,137,0,137,272,0,272,409
10/06/2021,OMN,FL,ASO,ES,Federal Contract Tower,0,0,15,0,15,0,0,136,0,136,0,0,151,0,151,250,0,250,401
10/07/2021,OMN,FL,ASO,ES,Federal Contract Tower,0,0,21,0,21,0,0,103,0,103,0,0,124,0,124,252,0,252,376
10/08/2021,OMN,FL,ASO,ES,Federal Contract Tower,0,0,5,0,5,0,0,127,0,127,0,0,132,0,132,136,0,136,268
10/09/2021,OMN,FL,ASO,ES,Federal Contract Tower,0,0,25,0,25,0,0,33,0,33,0,0,58,0,58,122,0,122,180
10/10/2021,OMN,FL,ASO,ES,Federal Contract Tower,0,0,5,0,5,0,0,18,0,18,0,0,23,0,23,10,0,10,33
10/11/2021,OMN,FL,ASO,ES,Federal Contract Tower,0,0,10,0,10,0,0,101,0,101,0,0,111,0,111,310,0,310,421
10/12/2021,OMN,FL,ASO,ES,Federal Contract Tower,0,0,18,0,18,0,0,140,0,140,0,0,158,0,158,292,0,292,450
10/13/2021,OMN,FL,ASO,ES,Federal Contract Tower,0,0,15,0,15,0,0,114,0,114,0,0,129,0,129,224,0,224,353
10/14/2021,OMN,FL,ASO,ES,Federal Contract Tower,0,0,12,0,12,0,0,87,0,87,0,0,99,0,99,210,0,210,309
10/15/2021,OMN,FL,ASO,ES,Federal Contract Tower,0,0,19,0,19,0,0,144,0,144,0,0,163,0,163,236,0,236,399
10/16/2021,OMN,FL,ASO,ES,Federal Contract Tower,0,0,14,0,14,0,0,130,0,130,0,0,144,0,144,208,0,208,352
10/17/2021,OMN,FL,ASO,ES,Federal Contract Tower,0,0,6,0,6,0,0,35,0,35,0,0,41,0,41,128,0,128,169
10/18/2021,OMN,FL,ASO,ES,Federal Contract Tower,0,0,12,0,12,0,0,117,0,117,0,0,129,0,129,268,0,268,397
10/19/2021,OMN,FL,ASO,ES,Federal Contract Tower,0,0,5,0,5,0,0,121,0,121,0,0,126,0,126,288,0,288,414
10/20/2021,OMN,FL,ASO,ES,Federal Contract Tower,0,0,11,0,11,0,0,168,0,168,0,0,179,0,179,256,0,256,435
10/21/2021,OMN,FL,ASO,ES,Federal Contract Tower,0,0,10,0,10,0,0,112,0,112,0,0,122,0,122,328,0,328,450
10/22/2021,OMN,FL,ASO,ES,Federal Contract Tower,0,0,21,0,21,0,0,112,0,112,0,0,133,0,133,434,0,434,567
10/23/2021,OMN,FL,ASO,ES,Federal Contract Tower,0,0,8,0,8,0,0,123,0,123,0,0,131,0,131,212,0,212,343
10/24/2021,OMN,FL,ASO,ES,Federal Contract Tower,0,0,6,0,6,0,0,31,0,31,0,0,37,0,37,110,0,110,147
10/25/2021,OMN,FL,ASO,ES,Federal Contract Tower,0,0,10,0,10,0,0,71,0,71,0,0,81,0,81,98,0,98,179
10/26/2021,OMN,FL,ASO,ES,Federal Contract Tower,0,0,8,0,8,0,0,80,0,80,0,0,88,0,88,122,0,122,210
10/27/2021,OMN,FL,ASO,ES,Federal Contract Tower,0,0,10,0,10,0,0,198,0,198,0,0,208,0,208,266,0,266,474
10/28/2021,OMN,FL,ASO,ES,Federal Contract Tower,0,0,3,0,3,0,0,45,0,45,0,0,48,0,48,90,0,90,138
10/29/2021,OMN,FL,ASO,ES,Federal Contract Tower,0,0,11,0,11,0,0,99,0,99,0,0,110,0,110,110,0,110,220
10/30/2021,OMN,FL,ASO,ES,Federal Contract Tower,0,0,10,0,10,0,0,143,0,143,0,0,153,0,153,124,0,124,277
10/31/2021,OMN,FL,ASO,ES,Federal Contract Tower,0,0,5,0,5,0,0,86,0,86,0,0,91,0,91,88,0,88,179
11/01/2021,OMN,FL,ASO,ES,Federal Contract Tower,0,0,6,0,6,0,0,130,0,130,0,0,136,0,136,256,0,256,392
11/02/2021,OMN,FL,ASO,ES,Federal Contract Tower,0,0,16,0,16,0,0,152,0,152,0,0,168,0,168,310,0,310,478
11/03/2021,OMN,FL,ASO,ES,Federal Contract Tower,0,0,13,0,13,0,0,273,0,273,0,0,286,0,286,260,0,260,546
11/04/2021,OMN,FL,ASO,ES,Federal Contract Tower,0,0,14,0,14,0,0,154,0,154,0,0,168,0,168,305,0,305,473
11/05/2021,OMN,FL,ASO,ES,Federal Contract Tower,0,0,0,0,0,0,0,0,0,0,0,0,0,0,0,0,0,0,0
11/06/2021,OMN,FL,ASO,ES,Federal Contract Tower,0,0,10,0,10,0,0,5,0,5,0,0,15,0,15,2,0,2,17
11/07/2021,OMN,FL,ASO,ES,Federal Contract Tower,0,0,4,0,4,0,0,11,0,11,0,0,15,0,15,40,0,40,55
11/08/2021,OMN,FL,ASO,ES,Federal Contract Tower,0,0,9,0,9,0,0,120,0,120,0,0,129,0,129,200,0,200,329
11/09/2021,OMN,FL,ASO,ES,Federal Contract Tower,0,0,14,0,14,0,0,187,0,187,0,0,201,0,201,344,0,344,545
11/10/2021,OMN,FL,ASO,ES,Federal Contract Tower,0,0,12,0,12,0,0,185,0,185,0,0,197,0,197,336,0,336,533
11/11/2021,OMN,FL,ASO,ES,Federal Contract Tower,0,0,21,0,21,0,0,168,0,168,0,0,189,0,189,334,0,334,523
11/12/2021,OMN,FL,ASO,ES,Federal Contract Tower,0,0,12,0,12,0,0,23,0,23,0,0,35,0,35,36,0,36,71
11/13/2021,OMN,FL,ASO,ES,Federal Contract Tower,0,0,11,0,11,0,0,44,0,44,0,0,55,0,55,62,0,62,117
11/14/2021,OMN,FL,ASO,ES,Federal Contract Tower,0,0,5,0,5,0,0,108,0,108,0,0,113,0,113,172,0,172,285
11/15/2021,OMN,FL,ASO,ES,Federal Contract Tower,0,0,8,0,8,0,0,149,0,149,0,0,157,0,157,346,0,346,503
11/16/2021,OMN,FL,ASO,ES,Federal Contract Tower,0,0,14,0,14,0,0,212,0,212,0,0,226,0,226,330,0,330,556
11/17/2021,OMN,FL,ASO,ES,Federal Contract Tower,0,0,22,0,22,0,0,242,0,242,0,0,264,0,264,400,0,400,664
11/18/2021,OMN,FL,ASO,ES,Federal Contract Tower,0,0,9,0,9,0,0,169,0,169,0,0,178,0,178,256,0,256,434
11/19/2021,OMN,FL,ASO,ES,Federal Contract Tower,0,0,6,0,6,0,0,39,0,39,0,0,45,0,45,106,0,106,151
11/20/2021,OMN,FL,ASO,ES,Federal Contract Tower,0,0,7,0,7,0,0,39,0,39,0,0,46,0,46,70,0,70,116
11/21/2021,OMN,FL,ASO,ES,Federal Contract Tower,0,0,12,0,12,0,0,42,0,42,0,0,54,0,54,70,0,70,124
11/22/2021,OMN,FL,ASO,ES,Federal Contract Tower,0,0,14,0,14,0,0,42,0,42,0,0,56,0,56,146,0,146,202
11/23/2021,OMN,FL,ASO,ES,Federal Contract Tower,0,0,13,0,13,0,0,95,0,95,0,0,108,0,108,70,0,70,178
11/24/2021,OMN,FL,ASO,ES,Federal Contract Tower,0,0,16,0,16,0,0,139,0,139,0,0,155,0,155,152,0,152,307
11/25/2021,OMN,FL,ASO,ES,Federal Contract Tower,0,0,3,0,3,0,0,17,0,17,0,0,20,0,20,0,0,0,20
11/26/2021,OMN,FL,ASO,ES,Federal Contract Tower,0,0,4,0,4,0,0,93,0,93,0,0,97,0,97,88,0,88,185
11/27/2021,OMN,FL,ASO,ES,Federal Contract Tower,0,0,2,0,2,0,0,100,0,100,0,0,102,0,102,182,0,182,284
11/28/2021,OMN,FL,ASO,ES,Federal Contract Tower,0,0,12,0,12,0,0,60,0,60,0,0,72,0,72,50,0,50,122
11/29/2021,OMN,FL,ASO,ES,Federal Contract Tower,0,0,16,0,16,0,0,124,0,124,0,0,140,0,140,340,0,340,480
11/30/2021,OMN,FL,ASO,ES,Federal Contract Tower,0,0,12,0,12,0,0,197,0,197,0,0,209,0,209,330,0,330,539
12/01/2021,OMN,FL,ASO,ES,Federal Contract Tower,0,0,8,0,8,0,0,201,0,201,0,0,209,0,209,280,0,280,489
12/02/2021,OMN,FL,ASO,ES,Federal Contract Tower,0,0,7,0,7,0,0,188,0,188,0,0,195,0,195,198,0,198,393
12/03/2021,OMN,FL,ASO,ES,Federal Contract Tower,0,0,7,0,7,0,0,152,0,152,0,0,159,0,159,336,0,336,495
12/04/2021,OMN,FL,ASO,ES,Federal Contract Tower,0,0,12,0,12,0,0,87,0,87,0,0,99,0,99,136,0,136,235
12/05/2021,OMN,FL,ASO,ES,Federal Contract Tower,0,0,8,0,8,0,0,45,0,45,0,0,53,0,53,64,0,64,117
12/06/2021,OMN,FL,ASO,ES,Federal Contract Tower,0,0,6,0,6,0,0,74,0,74,0,0,80,0,80,222,0,222,302
12/07/2021,OMN,FL,ASO,ES,Federal Contract Tower,0,0,9,0,9,0,0,13,0,13,0,0,22,0,22,46,0,46,68
12/08/2021,OMN,FL,ASO,ES,Federal Contract Tower,0,0,10,0,10,0,0,114,0,114,0,0,124,0,124,152,0,152,276
12/09/2021,OMN,FL,ASO,ES,Federal Contract Tower,0,0,14,0,14,0,0,133,0,133,0,0,147,0,147,392,0,392,539
12/10/2021,OMN,FL,ASO,ES,Federal Contract Tower,0,0,15,0,15,0,0,87,0,87,0,0,102,0,102,238,0,238,340
12/11/2021,OMN,FL,ASO,ES,Federal Contract Tower,0,0,4,0,4,0,0,74,0,74,0,0,78,0,78,76,0,76,154
12/12/2021,OMN,FL,ASO,ES,Federal Contract Tower,0,0,7,0,7,0,0,6,0,6,0,0,13,0,13,6,0,6,19
12/13/2021,OMN,FL,ASO,ES,Federal Contract Tower,0,0,13,0,13,0,0,116,0,116,0,0,129,0,129,264,0,264,393
12/14/2021,OMN,FL,ASO,ES,Federal Contract Tower,0,0,10,0,10,0,0,8,0,8,0,0,18,0,18,18,0,18,36
12/15/2021,OMN,FL,ASO,ES,Federal Contract Tower,0,0,17,0,17,0,0,71,0,71,0,0,88,0,88,112,0,112,200
12/16/2021,OMN,FL,ASO,ES,Federal Contract Tower,0,0,10,0,10,0,0,152,0,152,0,0,162,0,162,268,0,268,430
12/17/2021,OMN,FL,ASO,ES,Federal Contract Tower,0,0,11,0,11,0,0,88,0,88,0,0,99,0,99,292,0,292,391
12/18/2021,OMN,FL,ASO,ES,Federal Contract Tower,0,0,12,0,12,0,0,88,0,88,0,0,100,0,100,288,0,288,388
12/19/2021,OMN,FL,ASO,ES,Federal Contract Tower,0,0,5,0,5,0,0,17,0,17,0,0,22,0,22,14,0,14,36
12/20/2021,OMN,FL,ASO,ES,Federal Contract Tower,0,0,10,0,10,0,0,9,0,9,0,0,19,0,19,22,0,22,41
12/21/2021,OMN,FL,ASO,ES,Federal Contract Tower,0,0,0,0,0,0,0,0,0,0,0,0,0,0,0,0,0,0,0
12/22/2021,OMN,FL,ASO,ES,Federal Contract Tower,0,2,12,0,14,0,0,78,0,78,0,2,90,0,92,108,0,108,200
12/23/2021,OMN,FL,ASO,ES,Federal Contract Tower,0,0,9,0,9,0,0,102,0,102,0,0,111,0,111,230,0,230,341
12/24/2021,OMN,FL,ASO,ES,Federal Contract Tower,0,0,2,0,2,0,0,43,0,43,0,0,45,0,45,48,0,48,93
12/25/2021,OMN,FL,ASO,ES,Federal Contract Tower,0,0,0,0,0,0,0,9,0,9,0,0,9,0,9,4,0,4,13
12/26/2021,OMN,FL,ASO,ES,Federal Contract Tower,0,0,2,0,2,0,0,33,0,33,0,0,35,0,35,4,0,4,39
12/27/2021,OMN,FL,ASO,ES,Federal Contract Tower,0,0,7,0,7,0,0,55,0,55,0,0,62,0,62,154,0,154,216
12/28/2021,OMN,FL,ASO,ES,Federal Contract Tower,0,0,5,0,5,0,0,56,0,56,0,0,61,0,61,104,0,104,165
12/29/2021,OMN,FL,ASO,ES,Federal Contract Tower,0,0,4,0,4,0,0,86,0,86,0,0,90,0,90,176,0,176,266
12/30/2021,OMN,FL,ASO,ES,Federal Contract Tower,0,0,4,0,4,0,0,52,0,52,0,0,56,0,56,54,0,54,110
12/31/2021,OMN,FL,ASO,ES,Federal Contract Tower,0,0,3,0,3,0,0,4,0,4,0,0,7,0,7,2,0,2,9
01/01/2022,OMN,FL,ASO,ES,Federal Contract Tower,0,0,2,0,2,0,0,11,0,11,0,0,13,0,13,0,0,0,13
01/02/2022,OMN,FL,ASO,ES,Federal Contract Tower,0,0,6,0,6,0,0,20,0,20,0,0,26,0,26,20,0,20,46
01/03/2022,OMN,FL,ASO,ES,Federal Contract Tower,0,0,4,0,4,0,0,25,0,25,0,0,29,0,29,50,0,50,79
01/04/2022,OMN,FL,ASO,ES,Federal Contract Tower,0,0,14,0,14,0,0,88,0,88,0,0,102,0,102,154,0,154,256
01/05/2022,OMN,FL,ASO,ES,Federal Contract Tower,0,0,9,0,9,0,0,85,0,85,0,0,94,0,94,224,0,224,318
01/06/2022,OMN,FL,ASO,ES,Federal Contract Tower,0,0,13,0,13,0,0,88,0,88,0,0,101,0,101,312,0,312,413
01/07/2022,OMN,FL,ASO,ES,Federal Contract Tower,0,0,17,0,17,0,0,92,0,92,0,0,109,0,109,142,0,142,251
01/08/2022,OMN,FL,ASO,ES,Federal Contract Tower,0,0,7,0,7,0,0,72,0,72,0,0,79,0,79,44,0,44,123
01/09/2022,OMN,FL,ASO,ES,Federal Contract Tower,0,0,8,0,8,0,0,72,0,72,0,0,80,0,80,94,0,94,174
01/10/2022,OMN,FL,ASO,ES,Federal Contract Tower,0,0,9,0,9,0,0,40,0,40,0,0,49,0,49,160,0,160,209
01/11/2022,OMN,FL,ASO,ES,Federal Contract Tower,0,0,13,0,13,0,0,77,0,77,0,0,90,0,90,190,0,190,280
01/12/2022,OMN,FL,ASO,ES,Federal Contract Tower,0,0,12,0,12,0,0,152,0,152,0,0,164,0,164,230,0,230,394
01/13/2022,OMN,FL,ASO,ES,Federal Contract Tower,0,0,12,0,12,0,0,172,0,172,0,0,184,0,184,366,0,366,550
01/14/2022,OMN,FL,ASO,ES,Federal Contract Tower,0,0,9,0,9,0,0,146,0,146,0,0,155,0,155,246,0,246,401
01/15/2022,OMN,FL,ASO,ES,Federal Contract Tower,0,0,9,0,9,0,0,76,0,76,0,0,85,0,85,178,0,178,263
01/16/2022,OMN,FL,ASO,ES,Federal Contract Tower,0,0,0,0,0,0,0,0,0,0,0,0,0,0,0,0,0,0,0
01/17/2022,OMN,FL,ASO,ES,Federal Contract Tower,0,0,10,0,10,0,0,33,0,33,0,0,43,0,43,40,0,40,83
01/18/2022,OMN,FL,ASO,ES,Federal Contract Tower,0,0,9,0,9,0,0,167,0,167,0,0,176,0,176,364,0,364,540
01/19/2022,OMN,FL,ASO,ES,Federal Contract Tower,0,0,17,0,17,0,0,152,0,152,0,0,169,0,169,336,0,336,505
01/20/2022,OMN,FL,ASO,ES,Federal Contract Tower,0,0,21,0,21,0,0,140,0,140,0,0,161,0,161,212,0,212,373
01/21/2022,OMN,FL,ASO,ES,Federal Contract Tower,0,0,11,0,11,0,0,70,0,70,0,0,81,0,81,114,0,114,195
01/22/2022,OMN,FL,ASO,ES,Federal Contract Tower,0,0,2,0,2,0,0,0,0,0,0,0,2,0,2,0,0,0,2
01/23/2022,OMN,FL,ASO,ES,Federal Contract Tower,0,0,7,0,7,0,0,17,0,17,0,0,24,0,24,81,0,81,105
01/24/2022,OMN,FL,ASO,ES,Federal Contract Tower,0,0,9,0,9,0,0,110,0,110,0,0,119,0,119,299,0,299,418
01/25/2022,OMN,FL,ASO,ES,Federal Contract Tower,0,0,9,0,9,0,0,56,0,56,0,0,65,0,65,193,0,193,258
01/26/2022,OMN,FL,ASO,ES,Federal Contract Tower,0,0,4,0,4,0,0,7,0,7,0,0,11,0,11,16,0,16,27
01/27/2022,OMN,FL,ASO,ES,Federal Contract Tower,0,0,4,0,4,0,0,0,0,0,0,0,4,0,4,0,0,0,4
01/28/2022,OMN,FL,ASO,ES,Federal Contract Tower,0,0,12,0,12,0,0,65,0,65,0,0,77,0,77,154,0,154,231
01/29/2022,OMN,FL,ASO,ES,Federal Contract Tower,0,0,4,0,4,0,0,9,0,9,0,0,13,0,13,12,0,12,25
01/30/2022,OMN,FL,ASO,ES,Federal Contract Tower,0,0,11,0,11,0,0,82,0,82,0,0,93,0,93,244,0,244,337
01/31/2022,OMN,FL,ASO,ES,Federal Contract Tower,0,0,8,0,8,0,0,134,0,134,0,0,142,0,142,312,0,312,454
02/01/2022,OMN,FL,ASO,ES,Federal Contract Tower,0,0,9,0,9,0,0,169,0,169,0,0,178,0,178,336,0,336,514
02/02/2022,OMN,FL,ASO,ES,Federal Contract Tower,0,0,12,0,12,0,0,106,0,106,0,0,118,0,118,190,0,190,308
02/03/2022,OMN,FL,ASO,ES,Federal Contract Tower,0,0,12,0,12,0,0,114,0,114,0,0,126,0,126,234,0,234,360
02/04/2022,OMN,FL,ASO,ES,Federal Contract Tower,0,0,9,0,9,0,0,123,0,123,0,0,132,0,132,362,0,362,494
02/05/2022,OMN,FL,ASO,ES,Federal Contract Tower,0,0,5,0,5,0,0,26,0,26,0,0,31,0,31,16,0,16,47
02/06/2022,OMN,FL,ASO,ES,Federal Contract Tower,0,0,2,0,2,0,0,0,0,0,0,0,2,0,2,0,0,0,2
02/07/2022,OMN,FL,ASO,ES,Federal Contract Tower,0,0,5,0,5,0,0,0,0,0,0,0,5,0,5,8,0,8,13
02/08/2022,OMN,FL,ASO,ES,Federal Contract Tower,0,0,3,0,3,0,0,0,0,0,0,0,3,0,3,2,0,2,5
02/09/2022,OMN,FL,ASO,ES,Federal Contract Tower,0,0,16,0,16,0,0,160,0,160,0,0,176,0,176,224,0,224,400
02/10/2022,OMN,FL,ASO,ES,Federal Contract Tower,0,0,15,0,15,0,0,171,0,171,0,0,186,0,186,348,0,348,534
02/11/2022,OMN,FL,ASO,ES,Federal Contract Tower,0,0,11,0,11,0,0,130,0,130,0,0,141,0,141,488,0,488,629
02/12/2022,OMN,FL,ASO,ES,Federal Contract Tower,0,0,16,0,16,0,0,110,0,110,0,0,126,0,126,172,0,172,298
02/13/2022,OMN,FL,ASO,ES,Federal Contract Tower,0,0,2,0,2,0,0,7,0,7,0,0,9,0,9,46,0,46,55
02/14/2022,OMN,FL,ASO,ES,Federal Contract Tower,0,0,5,0,5,0,0,118,0,118,0,0,123,0,123,324,0,324,447
02/15/2022,OMN,FL,ASO,ES,Federal Contract Tower,0,0,20,0,20,0,0,169,0,169,0,0,189,0,189,332,0,332,521
02/16/2022,OMN,FL,ASO,ES,Federal Contract Tower,0,0,14,0,14,0,0,91,0,91,0,0,105,0,105,196,0,196,301
02/17/2022,OMN,FL,ASO,ES,Federal Contract Tower,0,0,13,0,13,0,0,87,0,87,0,0,100,0,100,170,0,170,270
02/18/2022,OMN,FL,ASO,ES,Federal Contract Tower,0,0,14,0,14,0,0,58,0,58,0,0,72,0,72,118,0,118,190
02/19/2022,OMN,FL,ASO,ES,Federal Contract Tower,0,0,16,0,16,0,0,95,0,95,0,0,111,0,111,196,0,196,307
02/20/2022,OMN,FL,ASO,ES,Federal Contract Tower,0,0,7,0,7,0,0,59,0,59,0,0,66,0,66,94,0,94,160
02/21/2022,OMN,FL,ASO,ES,Federal Contract Tower,0,0,14,0,14,0,0,146,0,146,0,0,160,0,160,242,0,242,402
02/22/2022,OMN,FL,ASO,ES,Federal Contract Tower,0,0,14,0,14,0,0,134,0,134,0,0,148,0,148,316,0,316,464
02/23/2022,OMN,FL,ASO,ES,Federal Contract Tower,0,0,23,0,23,0,0,176,0,176,0,0,199,0,199,360,0,360,559
02/24/2022,OMN,FL,ASO,ES,Federal Contract Tower,0,0,11,0,11,0,0,138,0,138,0,0,149,0,149,246,0,246,395
02/25/2022,OMN,FL,ASO,ES,Federal Contract Tower,0,0,14,0,14,0,0,112,0,112,0,0,126,0,126,286,0,286,412
02/26/2022,OMN,FL,ASO,ES,Federal Contract Tower,0,0,9,0,9,0,0,127,0,127,0,0,136,0,136,226,0,226,362
02/27/2022,OMN,FL,ASO,ES,Federal Contract Tower,0,0,10,0,10,0,0,63,0,63,0,0,73,0,73,158,0,158,231
02/28/2022,OMN,FL,ASO,ES,Federal Contract Tower,0,0,10,0,10,0,0,1,0,1,0,0,11,0,11,14,0,14,25
03/01/2022,OMN,FL,ASO,ES,Federal Contract Tower,0,0,6,0,6,0,0,33,0,33,0,0,39,0,39,104,0,104,143
03/02/2022,OMN,FL,ASO,ES,Federal Contract Tower,0,0,11,0,11,0,0,199,0,199,0,0,210,0,210,302,0,302,512
03/03/2022,OMN,FL,ASO,ES,Federal Contract Tower,0,0,6,0,6,0,0,142,0,142,0,0,148,0,148,242,0,242,390
03/04/2022,OMN,FL,ASO,ES,Federal Contract Tower,0,0,16,0,16,0,0,187,0,187,0,0,203,0,203,324,0,324,527
03/05/2022,OMN,FL,ASO,ES,Federal Contract Tower,0,0,12,0,12,0,0,88,0,88,0,0,100,0,100,118,0,118,218
03/06/2022,OMN,FL,ASO,ES,Federal Contract Tower,0,0,0,0,0,0,0,45,0,45,0,0,45,0,45,50,0,50,95
03/07/2022,OMN,FL,ASO,ES,Federal Contract Tower,0,0,10,0,10,0,0,112,0,112,0,0,122,0,122,383,0,383,505
03/08/2022,OMN,FL,ASO,ES,Federal Contract Tower,0,0,12,0,12,0,0,18,0,18,0,0,30,0,30,50,0,50,80
03/09/2022,OMN,FL,ASO,ES,Federal Contract Tower,0,0,10,0,10,0,0,10,0,10,0,0,20,0,20,32,0,32,52
03/10/2022,OMN,FL,ASO,ES,Federal Contract Tower,0,0,10,0,10,0,0,46,0,46,0,0,56,0,56,158,0,158,214
03/11/2022,OMN,FL,ASO,ES,Federal Contract Tower,0,0,6,0,6,0,0,28,0,28,0,0,34,0,34,80,0,80,114
03/12/2022,OMN,FL,ASO,ES,Federal Contract Tower,0,0,0,0,0,0,0,2,0,2,0,0,2,0,2,6,0,6,8
03/13/2022,OMN,FL,ASO,ES,Federal Contract Tower,0,0,12,0,12,0,0,98,0,98,0,0,110,0,110,224,0,224,334
03/14/2022,OMN,FL,ASO,ES,Federal Contract Tower,0,0,31,0,31,0,0,126,0,126,0,0,157,0,157,300,0,300,457
03/15/2022,OMN,FL,ASO,ES,Federal Contract Tower,0,0,9,0,9,0,0,72,0,72,0,0,81,0,81,230,0,230,311
03/16/2022,OMN,FL,ASO,ES,Federal Contract Tower,0,0,8,0,8,0,0,86,0,86,0,0,94,0,94,112,0,112,206
03/17/2022,OMN,FL,ASO,ES,Federal Contract Tower,0,0,14,0,14,0,0,200,0,200,0,0,214,0,214,324,0,324,538
03/18/2022,OMN,FL,ASO,ES,Federal Contract Tower,0,0,16,0,16,0,0,74,0,74,0,0,90,0,90,256,0,256,346
03/19/2022,OMN,FL,ASO,ES,Federal Contract Tower,0,0,12,0,12,0,0,88,0,88,0,0,100,0,100,230,0,230,330
03/20/2022,OMN,FL,ASO,ES,Federal Contract Tower,0,0,6,0,6,0,0,58,0,58,0,0,64,0,64,196,0,196,260
03/21/2022,OMN,FL,ASO,ES,Federal Contract Tower,0,0,10,0,10,0,0,146,0,146,0,0,156,0,156,262,0,262,418
03/22/2022,OMN,FL,ASO,ES,Federal Contract Tower,0,0,13,0,13,0,0,162,0,162,0,0,175,0,175,228,0,228,403
03/23/2022,OMN,FL,ASO,ES,Federal Contract Tower,0,0,6,0,6,0,0,78,0,78,0,0,84,0,84,82,0,82,166
03/24/2022,OMN,FL,ASO,ES,Federal Contract Tower,0,0,3,0,3,0,0,12,0,12,0,0,15,0,15,4,0,4,19
03/25/2022,OMN,FL,ASO,ES,Federal Contract Tower,0,0,17,0,17,0,0,165,0,165,0,0,182,0,182,244,0,244,426
03/26/2022,OMN,FL,ASO,ES,Federal Contract Tower,0,0,11,0,11,0,0,98,0,98,0,0,109,0,109,184,0,184,293
03/27/2022,OMN,FL,ASO,ES,Federal Contract Tower,0,0,8,0,8,0,0,65,0,65,0,0,73,0,73,140,0,140,213
03/28/2022,OMN,FL,ASO,ES,Federal Contract Tower,0,0,8,0,8,0,0,144,0,144,0,0,152,0,152,416,0,416,568
03/29/2022,OMN,FL,ASO,ES,Federal Contract Tower,0,0,10,0,10,0,0,178,0,178,0,0,188,0,188,352,0,352,540
03/30/2022,OMN,FL,ASO,ES,Federal Contract Tower,0,0,14,0,14,0,0,84,0,84,0,0,98,0,98,258,0,258,356
03/31/2022,OMN,FL,ASO,ES,Federal Contract Tower,0,0,9,0,9,0,0,63,0,63,0,0,72,0,72,104,0,104,176
04/01/2022,OMN,FL,ASO,ES,Federal Contract Tower,0,0,11,0,11,0,0,71,0,71,0,0,82,0,82,270,0,270,352
04/02/2022,OMN,FL,ASO,ES,Federal Contract Tower,0,0,1,0,1,0,0,0,0,0,0,0,1,0,1,0,0,0,1
04/03/2022,OMN,FL,ASO,ES,Federal Contract Tower,0,0,7,0,7,0,0,79,0,79,0,0,86,0,86,222,0,222,308
04/04/2022,OMN,FL,ASO,ES,Federal Contract Tower,0,0,15,0,15,0,0,165,0,165,0,0,180,0,180,404,0,404,584
04/05/2022,OMN,FL,ASO,ES,Federal Contract Tower,0,0,8,0,8,0,0,137,0,137,0,0,145,0,145,282,0,282,427
04/06/2022,OMN,FL,ASO,ES,Federal Contract Tower,0,0,11,0,11,0,0,190,0,190,0,0,201,0,201,230,0,230,431
04/07/2022,OMN,FL,ASO,ES,Federal Contract Tower,0,0,11,0,11,0,0,26,0,26,0,0,37,0,37,114,0,114,151
04/08/2022,OMN,FL,ASO,ES,Federal Contract Tower,0,0,10,0,10,0,0,124,0,124,0,0,134,0,134,156,0,156,290
04/09/2022,OMN,FL,ASO,ES,Federal Contract Tower,0,0,5,0,5,0,0,124,0,124,0,0,129,0,129,154,0,154,283
04/10/2022,OMN,FL,ASO,ES,Federal Contract Tower,0,0,11,0,11,0,0,112,0,112,0,0,123,0,123,341,0,341,464
04/11/2022,OMN,FL,ASO,ES,Federal Contract Tower,0,0,5,0,5,0,0,153,0,153,0,0,158,0,158,367,0,367,525
04/12/2022,OMN,FL,ASO,ES,Federal Contract Tower,0,0,9,0,9,0,0,158,0,158,0,0,167,0,167,320,0,320,487
04/13/2022,OMN,FL,ASO,ES,Federal Contract Tower,0,0,19,0,19,0,0,176,0,176,0,0,195,0,195,364,0,364,559
04/14/2022,OMN,FL,ASO,ES,Federal Contract Tower,0,0,12,0,12,0,0,168,0,168,0,0,180,0,180,400,0,400,580
04/15/2022,OMN,FL,ASO,ES,Federal Contract Tower,0,0,15,0,15,0,0,113,0,113,0,0,128,0,128,70,0,70,198
04/16/2022,OMN,FL,ASO,ES,Federal Contract Tower,0,0,16,0,16,0,0,143,0,143,0,0,159,0,159,240,0,240,399
04/17/2022,OMN,FL,ASO,ES,Federal Contract Tower,0,0,4,0,4,0,0,69,0,69,0,0,73,0,73,126,0,126,199
04/18/2022,OMN,FL,ASO,ES,Federal Contract Tower,0,0,14,0,14,0,0,70,0,70,0,0,84,0,84,252,0,252,336
04/19/2022,OMN,FL,ASO,ES,Federal Contract Tower,0,0,13,0,13,0,0,136,0,136,0,0,149,0,149,200,0,200,349
04/20/2022,OMN,FL,ASO,ES,Federal Contract Tower,0,0,11,0,11,0,0,104,0,104,0,0,115,0,115,168,0,168,283
04/21/2022,OMN,FL,ASO,ES,Federal Contract Tower,0,0,4,0,4,0,0,83,0,83,0,0,87,0,87,222,0,222,309
04/22/2022,OMN,FL,ASO,ES,Federal Contract Tower,0,0,16,0,16,0,0,90,0,90,0,0,106,0,106,280,0,280,386
04/23/2022,OMN,FL,ASO,ES,Federal Contract Tower,0,0,10,0,10,0,0,61,0,61,0,0,71,0,71,106,0,106,177
04/24/2022,OMN,FL,ASO,ES,Federal Contract Tower,0,0,7,0,7,0,0,57,0,57,0,0,64,0,64,74,0,74,138
04/25/2022,OMN,FL,ASO,ES,Federal Contract Tower,0,0,14,0,14,0,0,150,0,150,0,0,164,0,164,160,0,160,324
04/26/2022,OMN,FL,ASO,ES,Federal Contract Tower,0,0,14,0,14,0,0,183,0,183,0,0,197,0,197,300,0,300,497
04/27/2022,OMN,FL,ASO,ES,Federal Contract Tower,0,0,10,0,10,0,0,174,0,174,0,0,184,0,184,196,0,196,380
04/28/2022,OMN,FL,ASO,ES,Federal Contract Tower,0,0,19,0,19,0,0,82,0,82,0,0,101,0,101,90,0,90,191
04/29/2022,OMN,FL,ASO,ES,Federal Contract Tower,0,0,17,0,17,0,0,99,0,99,0,0,116,0,116,182,0,182,298
04/30/2022,OMN,FL,ASO,ES,Federal Contract Tower,0,0,7,0,7,0,0,123,0,123,0,0,130,0,130,196,0,196,326
05/01/2022,OMN,FL,ASO,ES,Federal Contract Tower,0,0,10,0,10,0,0,58,0,58,0,0,68,0,68,100,0,100,168
05/02/2022,OMN,FL,ASO,ES,Federal Contract Tower,0,0,23,0,23,0,0,142,0,142,0,0,165,0,165,246,0,246,411
05/03/2022,OMN,FL,ASO,ES,Federal Contract Tower,0,0,11,0,11,0,0,150,0,150,0,0,161,0,161,332,0,332,493
05/04/2022,OMN,FL,ASO,ES,Federal Contract Tower,0,0,5,0,5,0,0,197,0,197,0,0,202,0,202,230,0,230,432
05/05/2022,OMN,FL,ASO,ES,Federal Contract Tower,0,0,12,0,12,0,0,191,0,191,0,0,203,0,203,236,0,236,439
05/06/2022,OMN,FL,ASO,ES,Federal Contract Tower,0,0,10,0,10,0,0,101,0,101,0,0,111,0,111,204,0,204,315
05/07/2022,OMN,FL,ASO,ES,Federal Contract Tower,0,0,5,0,5,0,0,43,0,43,0,0,48,0,48,34,0,34,82
05/08/2022,OMN,FL,ASO,ES,Federal Contract Tower,0,0,6,0,6,0,0,43,0,43,0,0,49,0,49,138,0,138,187
05/09/2022,OMN,FL,ASO,ES,Federal Contract Tower,0,0,21,0,21,0,0,90,0,90,0,0,111,0,111,126,0,126,237
05/10/2022,OMN,FL,ASO,ES,Federal Contract Tower,0,0,10,0,10,0,0,77,0,77,0,0,87,0,87,124,0,124,211
05/11/2022,OMN,FL,ASO,ES,Federal Contract Tower,0,0,8,0,8,0,0,72,0,72,0,0,80,0,80,148,0,148,228
05/12/2022,OMN,FL,ASO,ES,Federal Contract Tower,0,0,16,0,16,0,0,87,0,87,0,0,103,0,103,192,0,192,295
05/13/2022,OMN,FL,ASO,ES,Federal Contract Tower,0,0,13,0,13,0,0,157,0,157,0,0,170,0,170,296,0,296,466
05/14/2022,OMN,FL,ASO,ES,Federal Contract Tower,0,0,12,0,12,0,0,202,0,202,0,0,214,0,214,274,0,274,488
05/15/2022,OMN,FL,ASO,ES,Federal Contract Tower,0,0,4,0,4,0,0,40,0,40,0,0,44,0,44,82,0,82,126
05/16/2022,OMN,FL,ASO,ES,Federal Contract Tower,0,0,11,0,11,0,0,65,0,65,0,0,76,0,76,206,0,206,282
05/17/2022,OMN,FL,ASO,ES,Federal Contract Tower,0,0,8,0,8,0,0,105,0,105,0,0,113,0,113,214,0,214,327
05/18/2022,OMN,FL,ASO,ES,Federal Contract Tower,0,0,16,0,16,0,0,145,0,145,0,0,161,0,161,186,0,186,347
05/19/2022,OMN,FL,ASO,ES,Federal Contract Tower,0,0,17,0,17,0,0,191,0,191,0,0,208,0,208,266,0,266,474
05/20/2022,OMN,FL,ASO,ES,Federal Contract Tower,0,0,12,0,12,0,0,102,0,102,0,0,114,0,114,292,0,292,406
05/21/2022,OMN,FL,ASO,ES,Federal Contract Tower,0,0,5,0,5,0,0,40,0,40,0,0,45,0,45,134,0,134,179
05/22/2022,OMN,FL,ASO,ES,Federal Contract Tower,0,0,15,0,15,0,0,16,0,16,0,0,31,0,31,46,0,46,77
05/23/2022,OMN,FL,ASO,ES,Federal Contract Tower,0,0,16,0,16,0,0,109,0,109,0,0,125,0,125,226,0,226,351
05/24/2022,OMN,FL,ASO,ES,Federal Contract Tower,0,0,15,0,15,0,0,137,0,137,0,0,152,0,152,240,0,240,392
05/25/2022,OMN,FL,ASO,ES,Federal Contract Tower,0,0,12,0,12,0,0,99,0,99,0,0,111,0,111,86,0,86,197
05/26/2022,OMN,FL,ASO,ES,Federal Contract Tower,0,0,13,0,13,0,0,99,0,99,0,0,112,0,112,124,0,124,236
05/27/2022,OMN,FL,ASO,ES,Federal Contract Tower,0,0,14,0,14,0,0,109,0,109,0,0,123,0,123,138,0,138,261
05/28/2022,OMN,FL,ASO,ES,Federal Contract Tower,0,0,8,0,8,0,0,89,0,89,0,0,97,0,97,92,0,92,189
05/29/2022,OMN,FL,ASO,ES,Federal Contract Tower,0,0,4,0,4,0,0,42,0,42,0,0,46,0,46,80,0,80,126
05/30/2022,OMN,FL,ASO,ES,Federal Contract Tower,0,0,10,0,10,0,0,112,0,112,0,0,122,0,122,338,0,338,460
05/31/2022,OMN,FL,ASO,ES,Federal Contract Tower,0,0,14,0,14,0,0,117,0,117,0,0,131,0,131,156,0,156,287
06/01/2022,OMN,FL,ASO,ES,Federal Contract Tower,0,0,16,0,16,0,0,124,0,124,0,0,140,0,140,136,0,136,276
06/02/2022,OMN,FL,ASO,ES,Federal Contract Tower,0,0,19,0,19,0,0,170,0,170,0,0,189,0,189,240,0,240,429
06/03/2022,OMN,FL,ASO,ES,Federal Contract Tower,0,0,11,0,11,0,0,168,0,168,0,0,179,0,179,242,0,242,421
06/04/2022,OMN,FL,ASO,ES,Federal Contract Tower,0,0,4,0,4,0,0,14,0,14,0,0,18,0,18,24,0,24,42
06/05/2022,OMN,FL,ASO,ES,Federal Contract Tower,0,0,5,0,5,0,0,31,0,31,0,0,36,0,36,68,0,68,104
06/06/2022,OMN,FL,ASO,ES,Federal Contract Tower,0,0,6,0,6,0,0,102,0,102,0,0,108,0,108,164,0,164,272
06/07/2022,OMN,FL,ASO,ES,Federal Contract Tower,0,0,16,0,16,0,0,122,0,122,0,0,138,0,138,218,0,218,356
06/08/2022,OMN,FL,ASO,ES,Federal Contract Tower,0,0,7,0,7,0,0,124,0,124,0,0,131,0,131,195,0,195,326
06/09/2022,OMN,FL,ASO,ES,Federal Contract Tower,0,0,14,0,14,0,0,110,0,110,0,0,124,0,124,190,0,190,314
06/10/2022,OMN,FL,ASO,ES,Federal Contract Tower,0,0,2,0,2,0,0,60,0,60,0,0,62,0,62,76,0,76,138
06/11/2022,OMN,FL,ASO,ES,Federal Contract Tower,0,0,8,0,8,0,0,59,0,59,0,0,67,0,67,114,0,114,181
06/12/2022,OMN,FL,ASO,ES,Federal Contract Tower,0,0,5,0,5,0,0,43,0,43,0,0,48,0,48,42,0,42,90
06/13/2022,OMN,FL,ASO,ES,Federal Contract Tower,0,0,14,0,14,0,0,77,0,77,0,0,91,0,91,124,0,124,215
06/14/2022,OMN,FL,ASO,ES,Federal Contract Tower,0,0,12,1,13,0,0,104,0,104,0,0,116,1,117,190,2,192,309
06/15/2022,OMN,FL,ASO,ES,Federal Contract Tower,0,0,13,0,13,0,0,159,0,159,0,0,172,0,172,154,0,154,326
06/16/2022,OMN,FL,ASO,ES,Federal Contract Tower,0,0,15,0,15,0,0,129,0,129,0,0,144,0,144,282,0,282,426
06/17/2022,OMN,FL,ASO,ES,Federal Contract Tower,0,0,7,0,7,0,0,98,0,98,0,0,105,0,105,170,0,170,275
06/18/2022,OMN,FL,ASO,ES,Federal Contract Tower,0,0,7,0,7,0,0,75,0,75,0,0,82,0,82,62,0,62,144
06/19/2022,OMN,FL,ASO,ES,Federal Contract Tower,0,0,6,0,6,0,0,49,0,49,0,0,55,0,55,92,0,92,147
06/20/2022,OMN,FL,ASO,ES,Federal Contract Tower,0,0,20,0,20,0,0,60,0,60,0,0,80,0,80,150,0,150,230
06/21/2022,OMN,FL,ASO,ES,Federal Contract Tower,0,0,12,0,12,0,0,94,0,94,0,0,106,0,106,100,0,100,206
06/22/2022,OMN,FL,ASO,ES,Federal Contract Tower,0,0,12,0,12,0,0,96,0,96,0,0,108,0,108,172,0,172,280
06/23/2022,OMN,FL,ASO,ES,Federal Contract Tower,0,0,9,0,9,0,0,93,0,93,0,0,102,0,102,162,0,162,264
06/24/2022,OMN,FL,ASO,ES,Federal Contract Tower,0,0,7,0,7,0,0,14,0,14,0,0,21,0,21,18,0,18,39
06/25/2022,OMN,FL,ASO,ES,Federal Contract Tower,0,0,8,0,8,0,0,58,0,58,0,0,66,0,66,22,0,22,88
06/26/2022,OMN,FL,ASO,ES,Federal Contract Tower,0,0,4,0,4,0,0,48,0,48,0,0,52,0,52,46,0,46,98
06/27/2022,OMN,FL,ASO,ES,Federal Contract Tower,0,0,9,0,9,0,0,57,0,57,0,0,66,0,66,102,0,102,168
06/28/2022,OMN,FL,ASO,ES,Federal Contract Tower,0,0,10,0,10,0,0,134,0,134,0,0,144,0,144,146,0,146,290
06/29/2022,OMN,FL,ASO,ES,Federal Contract Tower,0,0,18,0,18,0,0,171,0,171,0,0,189,0,189,190,0,190,379
06/30/2022,OMN,FL,ASO,ES,Federal Contract Tower,0,0,7,0,7,0,0,69,0,69,0,0,76,0,76,132,0,132,208
07/01/2022,OMN,FL,ASO,ES,Federal Contract Tower,0,0,18,0,18,0,0,91,0,91,0,0,109,0,109,96,0,96,205
07/02/2022,OMN,FL,ASO,ES,Federal Contract Tower,0,0,1,0,1,0,0,68,0,68,0,0,69,0,69,144,0,144,213
07/03/2022,OMN,FL,ASO,ES,Federal Contract Tower,0,0,2,0,2,0,0,25,0,25,0,0,27,0,27,116,0,116,143
07/04/2022,OMN,FL,ASO,ES,Federal Contract Tower,0,0,10,0,10,0,0,54,0,54,0,0,64,0,64,80,0,80,144
07/05/2022,OMN,FL,ASO,ES,Federal Contract Tower,0,0,20,0,20,0,0,122,0,122,0,0,142,0,142,222,0,222,364
07/06/2022,OMN,FL,ASO,ES,Federal Contract Tower,0,0,14,0,14,0,0,109,0,109,0,0,123,0,123,174,0,174,297
07/07/2022,OMN,FL,ASO,ES,Federal Contract Tower,0,0,19,0,19,0,0,68,0,68,0,0,87,0,87,166,0,166,253
07/08/2022,OMN,FL,ASO,ES,Federal Contract Tower,0,0,13,0,13,0,0,86,0,86,0,0,99,0,99,206,0,206,305
07/09/2022,OMN,FL,ASO,ES,Federal Contract Tower,0,0,6,0,6,0,0,48,0,48,0,0,54,0,54,152,0,152,206
07/10/2022,OMN,FL,ASO,ES,Federal Contract Tower,0,0,4,0,4,0,0,45,0,45,0,0,49,0,49,114,0,114,163
07/11/2022,OMN,FL,ASO,ES,Federal Contract Tower,0,0,18,0,18,0,0,61,0,61,0,0,79,0,79,114,0,114,193
07/12/2022,OMN,FL,ASO,ES,Federal Contract Tower,0,0,7,0,7,0,0,77,0,77,0,0,84,0,84,162,0,162,246
07/13/2022,OMN,FL,ASO,ES,Federal Contract Tower,0,0,12,0,12,0,0,99,0,99,0,0,111,0,111,102,0,102,213
07/14/2022,OMN,FL,ASO,ES,Federal Contract Tower,0,0,21,0,21,0,0,101,0,101,0,0,122,0,122,200,0,200,322
07/15/2022,OMN,FL,ASO,ES,Federal Contract Tower,0,0,15,0,15,0,0,67,0,67,0,0,82,0,82,86,0,86,168
07/16/2022,OMN,FL,ASO,ES,Federal Contract Tower,0,0,12,0,12,0,0,46,0,46,0,0,58,0,58,18,0,18,76
07/17/2022,OMN,FL,ASO,ES,Federal Contract Tower,0,0,5,0,5,0,0,35,0,35,0,0,40,0,40,48,0,48,88
07/18/2022,OMN,FL,ASO,ES,Federal Contract Tower,0,0,11,0,11,0,0,53,0,53,0,0,64,0,64,128,0,128,192
07/19/2022,OMN,FL,ASO,ES,Federal Contract Tower,0,0,12,0,12,0,0,114,0,114,0,0,126,0,126,172,0,172,298
07/20/2022,OMN,FL,ASO,ES,Federal Contract Tower,0,0,10,0,10,0,0,135,0,135,0,0,145,0,145,180,0,180,325
07/21/2022,OMN,FL,ASO,ES,Federal Contract Tower,0,0,16,0,16,0,0,122,0,122,0,0,138,0,138,120,0,120,258
07/22/2022,OMN,FL,ASO,ES,Federal Contract Tower,0,0,20,0,20,0,0,114,0,114,0,0,134,0,134,170,0,170,304
07/23/2022,OMN,FL,ASO,ES,Federal Contract Tower,0,0,13,0,13,0,0,88,0,88,0,0,101,0,101,228,0,228,329
07/24/2022,OMN,FL,ASO,ES,Federal Contract Tower,0,0,9,0,9,0,0,68,0,68,0,0,77,0,77,104,0,104,181
07/25/2022,OMN,FL,ASO,ES,Federal Contract Tower,0,0,19,0,19,0,0,99,0,99,0,0,118,0,118,172,0,172,290
07/26/2022,OMN,FL,ASO,ES,Federal Contract Tower,0,0,16,0,16,0,0,75,0,75,0,0,91,0,91,82,0,82,173
07/27/2022,OMN,FL,ASO,ES,Federal Contract Tower,0,0,8,0,8,0,0,127,0,127,0,0,135,0,135,140,0,140,275
07/28/2022,OMN,FL,ASO,ES,Federal Contract Tower,0,0,12,0,12,0,0,133,0,133,0,0,145,0,145,236,0,236,381
07/29/2022,OMN,FL,ASO,ES,Federal Contract Tower,0,0,19,0,19,0,0,150,0,150,0,0,169,0,169,204,0,204,373
07/30/2022,OMN,FL,ASO,ES,Federal Contract Tower,0,0,8,0,8,0,0,96,0,96,0,0,104,0,104,142,0,142,246
07/31/2022,OMN,FL,ASO,ES,Federal Contract Tower,0,0,1,0,1,0,0,43,0,43,0,0,44,0,44,94,0,94,138
08/01/2022,OMN,FL,ASO,ES,Federal Contract Tower,0,0,13,0,13,0,0,63,0,63,0,0,76,0,76,152,0,152,228
08/02/2022,OMN,FL,ASO,ES,Federal Contract Tower,0,0,14,0,14,0,0,122,0,122,0,0,136,0,136,116,0,116,252
08/03/2022,OMN,FL,ASO,ES,Federal Contract Tower,0,0,13,0,13,0,0,127,0,127,0,0,140,0,140,140,0,140,280
08/04/2022,OMN,FL,ASO,ES,Federal Contract Tower,0,0,18,0,18,0,0,78,0,78,0,0,96,0,96,180,0,180,276
08/05/2022,OMN,FL,ASO,ES,Federal Contract Tower,0,0,4,0,4,0,0,66,0,66,0,0,70,0,70,140,0,140,210
08/06/2022,OMN,FL,ASO,ES,Federal Contract Tower,0,0,10,0,10,0,0,72,0,72,0,0,82,0,82,108,0,108,190
08/07/2022,OMN,FL,ASO,ES,Federal Contract Tower,0,0,6,0,6,0,0,27,0,27,0,0,33,0,33,24,0,24,57
08/08/2022,OMN,FL,ASO,ES,Federal Contract Tower,0,0,11,0,11,0,0,52,0,52,0,0,63,0,63,160,0,160,223
08/09/2022,OMN,FL,ASO,ES,Federal Contract Tower,0,0,12,0,12,0,0,61,0,61,0,0,73,0,73,120,0,120,193
08/10/2022,OMN,FL,ASO,ES,Federal Contract Tower,0,0,19,0,19,0,0,130,0,130,0,0,149,0,149,180,0,180,329
08/11/2022,OMN,FL,ASO,ES,Federal Contract Tower,0,0,7,0,7,0,0,61,0,61,0,0,68,0,68,124,0,124,192
08/12/2022,OMN,FL,ASO,ES,Federal Contract Tower,0,0,11,0,11,0,0,104,0,104,0,0,115,0,115,188,0,188,303
08/13/2022,OMN,FL,ASO,ES,Federal Contract Tower,0,0,7,0,7,0,0,59,0,59,0,0,66,0,66,82,0,82,148
08/14/2022,OMN,FL,ASO,ES,Federal Contract Tower,0,0,13,0,13,0,0,34,0,34,0,0,47,0,47,52,0,52,99
08/15/2022,OMN,FL,ASO,ES,Federal Contract Tower,0,0,17,0,17,0,0,83,0,83,0,0,100,0,100,98,0,98,198
08/16/2022,OMN,FL,ASO,ES,Federal Contract Tower,0,0,18,0,18,0,0,99,0,99,0,0,117,0,117,292,0,292,409
08/17/2022,OMN,FL,ASO,ES,Federal Contract Tower,0,0,9,0,9,0,0,109,0,109,0,0,118,0,118,116,0,116,234
08/18/2022,OMN,FL,ASO,ES,Federal Contract Tower,0,0,14,0,14,0,0,92,0,92,0,0,106,0,106,182,0,182,288
08/19/2022,OMN,FL,ASO,ES,Federal Contract Tower,0,0,20,0,20,0,0,104,0,104,0,0,124,0,124,200,0,200,324
08/20/2022,OMN,FL,ASO,ES,Federal Contract Tower,0,0,11,0,11,0,0,89,0,89,0,0,100,0,100,170,0,170,270
08/21/2022,OMN,FL,ASO,ES,Federal Contract Tower,0,2,2,0,4,0,0,33,0,33,0,2,35,0,37,34,0,34,71
08/22/2022,OMN,FL,ASO,ES,Federal Contract Tower,0,0,15,0,15,0,0,77,0,77,0,0,92,0,92,118,0,118,210
08/23/2022,OMN,FL,ASO,ES,Federal Contract Tower,0,0,2,0,2,0,0,60,0,60,0,0,62,0,62,64,0,64,126
08/24/2022,OMN,FL,ASO,ES,Federal Contract Tower,0,0,15,0,15,0,0,100,0,100,0,0,115,0,115,128,0,128,243
08/25/2022,OMN,FL,ASO,ES,Federal Contract Tower,0,0,10,0,10,0,0,74,0,74,0,0,84,0,84,142,0,142,226
08/26/2022,OMN,FL,ASO,ES,Federal Contract Tower,0,0,8,0,8,0,0,59,0,59,0,0,67,0,67,90,0,90,157
08/27/2022,OMN,FL,ASO,ES,Federal Contract Tower,0,0,9,0,9,0,0,80,0,80,0,0,89,0,89,44,0,44,133
08/28/2022,OMN,FL,ASO,ES,Federal Contract Tower,0,0,1,0,1,0,0,41,0,41,0,0,42,0,42,68,0,68,110
08/29/2022,OMN,FL,ASO,ES,Federal Contract Tower,0,0,9,0,9,0,0,65,0,65,0,0,74,0,74,86,0,86,160
08/30/2022,OMN,FL,ASO,ES,Federal Contract Tower,0,0,15,0,15,0,0,87,0,87,0,0,102,0,102,148,0,148,250
08/31/2022,OMN,FL,ASO,ES,Federal Contract Tower,0,0,12,0,12,0,0,99,0,99,0,0,111,0,111,76,0,76,187
09/01/2022,OMN,FL,ASO,ES,Federal Contract Tower,0,0,21,0,21,0,0,120,0,120,0,0,141,0,141,200,0,200,341
09/02/2022,OMN,FL,ASO,ES,Federal Contract Tower,0,0,8,0,8,0,0,54,0,54,0,0,62,0,62,56,0,56,118
09/03/2022,OMN,FL,ASO,ES,Federal Contract Tower,0,0,6,0,6,0,0,68,0,68,0,0,74,0,74,78,0,78,152
09/04/2022,OMN,FL,ASO,ES,Federal Contract Tower,0,0,4,0,4,0,0,51,0,51,0,0,55,0,55,84,0,84,139
09/05/2022,OMN,FL,ASO,ES,Federal Contract Tower,0,0,8,0,8,0,0,56,0,56,0,0,64,0,64,42,0,42,106
09/06/2022,OMN,FL,ASO,ES,Federal Contract Tower,0,0,7,0,7,0,0,58,0,58,0,0,65,0,65,139,0,139,204
09/07/2022,OMN,FL,ASO,ES,Federal Contract Tower,0,0,9,0,9,0,0,138,0,138,0,0,147,0,147,170,0,170,317
09/08/2022,OMN,FL,ASO,ES,Federal Contract Tower,0,0,13,0,13,0,0,94,0,94,0,0,107,0,107,122,0,122,229
09/09/2022,OMN,FL,ASO,ES,Federal Contract Tower,0,0,10,0,10,0,0,67,0,67,0,0,77,0,77,156,0,156,233
09/10/2022,OMN,FL,ASO,ES,Federal Contract Tower,0,0,9,0,9,0,0,87,0,87,0,0,96,0,96,118,0,118,214
09/11/2022,OMN,FL,ASO,ES,Federal Contract Tower,0,0,7,0,7,0,0,51,0,51,0,0,58,0,58,66,0,66,124
09/12/2022,OMN,FL,ASO,ES,Federal Contract Tower,0,0,8,0,8,0,0,74,0,74,0,0,82,0,82,132,0,132,214
09/13/2022,OMN,FL,ASO,ES,Federal Contract Tower,0,0,8,0,8,0,0,56,0,56,0,0,64,0,64,148,0,148,212
09/14/2022,OMN,FL,ASO,ES,Federal Contract Tower,0,0,10,0,10,0,0,116,0,116,0,0,126,0,126,120,0,120,246
09/15/2022,OMN,FL,ASO,ES,Federal Contract Tower,0,0,14,0,14,0,0,118,0,118,0,0,132,0,132,90,0,90,222
09/16/2022,OMN,FL,ASO,ES,Federal Contract Tower,0,0,11,0,11,0,0,75,0,75,0,0,86,0,86,98,0,98,184
09/17/2022,OMN,FL,ASO,ES,Federal Contract Tower,0,0,8,0,8,0,0,19,0,19,0,0,27,0,27,36,0,36,63
09/18/2022,OMN,FL,ASO,ES,Federal Contract Tower,0,0,7,0,7,0,0,29,0,29,0,0,36,0,36,20,0,20,56
09/19/2022,OMN,FL,ASO,ES,Federal Contract Tower,0,0,11,0,11,0,0,103,0,103,0,0,114,0,114,142,0,142,256
09/20/2022,OMN,FL,ASO,ES,Federal Contract Tower,0,0,11,0,11,0,0,62,0,62,0,0,73,0,73,114,0,114,187
09/21/2022,OMN,FL,ASO,ES,Federal Contract Tower,0,0,14,0,14,0,0,95,0,95,0,0,109,0,109,58,0,58,167
09/22/2022,OMN,FL,ASO,ES,Federal Contract Tower,0,0,17,0,17,0,0,88,0,88,0,0,105,0,105,104,0,104,209
09/23/2022,OMN,FL,ASO,ES,Federal Contract Tower,0,0,14,0,14,0,0,56,0,56,0,0,70,0,70,58,0,58,128
09/24/2022,OMN,FL,ASO,ES,Federal Contract Tower,0,0,7,0,7,0,0,61,0,61,0,0,68,0,68,132,0,132,200
09/25/2022,OMN,FL,ASO,ES,Federal Contract Tower,0,0,6,0,6,0,0,44,0,44,0,0,50,0,50,95,0,95,145
09/26/2022,OMN,FL,ASO,ES,Federal Contract Tower,0,0,5,0,5,0,0,108,0,108,0,0,113,0,113,78,0,78,191
09/27/2022,OMN,FL,ASO,ES,Federal Contract Tower,0,0,2,0,2,0,0,71,0,71,0,0,73,0,73,60,0,60,133
09/28/2022,OMN,FL,ASO,ES,Federal Contract Tower,0,0,0,0,0,0,0,0,0,0,0,0,0,0,0,0,0,0,0
09/29/2022,OMN,FL,ASO,ES,Federal Contract Tower,0,0,0,0,0,0,0,0,0,0,0,0,0,0,0,0,0,0,0
09/30/2022,OMN,FL,ASO,ES,Federal Contract Tower,0,0,0,0,0,0,0,0,0,0,0,0,0,0,0,0,0,0,0
10/01/2022,OMN,FL,ASO,ES,Federal Contract Tower,0,0,0,0,0,0,0,13,0,13,0,0,13,0,13,24,0,24,37
10/02/2022,OMN,FL,ASO,ES,Federal Contract Tower,0,0,3,0,3,0,0,40,0,40,0,0,43,0,43,40,0,40,83
10/03/2022,OMN,FL,ASO,ES,Federal Contract Tower,0,0,14,0,14,0,0,128,0,128,0,0,142,0,142,244,0,244,386
10/04/2022,OMN,FL,ASO,ES,Federal Contract Tower,0,0,9,0,9,0,0,145,0,145,0,0,154,0,154,198,0,198,352
10/05/2022,OMN,FL,ASO,ES,Federal Contract Tower,0,0,11,0,11,0,0,147,0,147,0,0,158,0,158,336,0,336,494
10/06/2022,OMN,FL,ASO,ES,Federal Contract Tower,0,0,10,0,10,0,0,127,0,127,0,0,137,0,137,280,0,280,417
10/07/2022,OMN,FL,ASO,ES,Federal Contract Tower,0,0,15,0,15,0,0,138,0,138,0,0,153,0,153,331,0,331,484
10/08/2022,OMN,FL,ASO,ES,Federal Contract Tower,0,0,4,0,4,0,0,59,0,59,0,0,63,0,63,186,0,186,249
10/09/2022,OMN,FL,ASO,ES,Federal Contract Tower,0,0,5,0,5,0,0,40,0,40,0,0,45,0,45,54,0,54,99
10/10/2022,OMN,FL,ASO,ES,Federal Contract Tower,0,0,13,0,13,0,0,98,0,98,0,0,111,0,111,240,0,240,351
10/11/2022,OMN,FL,ASO,ES,Federal Contract Tower,0,0,7,0,7,0,0,130,0,130,0,0,137,0,137,244,0,244,381
10/12/2022,OMN,FL,ASO,ES,Federal Contract Tower,0,0,10,0,10,0,0,144,0,144,0,0,154,0,154,278,0,278,432
10/13/2022,OMN,FL,ASO,ES,Federal Contract Tower,0,0,14,0,14,0,0,165,0,165,0,0,179,0,179,232,0,232,411
10/14/2022,OMN,FL,ASO,ES,Federal Contract Tower,0,0,11,0,11,0,0,133,0,133,0,0,144,0,144,248,0,248,392
10/15/2022,OMN,FL,ASO,ES,Federal Contract Tower,0,0,7,0,7,0,0,95,0,95,0,0,102,0,102,232,0,232,334
10/16/2022,OMN,FL,ASO,ES,Federal Contract Tower,0,0,2,0,2,0,0,47,0,47,0,0,49,0,49,26,0,26,75
10/17/2022,OMN,FL,ASO,ES,Federal Contract Tower,0,0,7,0,7,0,0,118,0,118,0,0,125,0,125,292,0,292,417
10/18/2022,OMN,FL,ASO,ES,Federal Contract Tower,0,0,13,0,13,0,0,140,0,140,0,0,153,0,153,224,0,224,377
10/19/2022,OMN,FL,ASO,ES,Federal Contract Tower,0,0,11,0,11,0,0,116,0,116,0,0,127,0,127,306,0,306,433
10/20/2022,OMN,FL,ASO,ES,Federal Contract Tower,0,0,10,0,10,0,0,190,0,190,0,0,200,0,200,340,0,340,540
10/21/2022,OMN,FL,ASO,ES,Federal Contract Tower,0,0,8,0,8,0,0,152,0,152,0,0,160,0,160,418,0,418,578
10/22/2022,OMN,FL,ASO,ES,Federal Contract Tower,0,0,12,0,12,0,0,71,0,71,0,0,83,0,83,112,0,112,195
10/23/2022,OMN,FL,ASO,ES,Federal Contract Tower,0,0,8,0,8,0,0,36,0,36,0,0,44,0,44,88,0,88,132
10/24/2022,OMN,FL,ASO,ES,Federal Contract Tower,0,0,16,0,16,0,0,83,0,83,0,0,99,0,99,304,0,304,403
10/25/2022,OMN,FL,ASO,ES,Federal Contract Tower,0,0,16,0,16,0,0,171,0,171,0,0,187,0,187,270,0,270,457
10/26/2022,OMN,FL,ASO,ES,Federal Contract Tower,0,0,9,0,9,0,0,128,0,128,0,0,137,0,137,256,0,256,393
10/27/2022,OMN,FL,ASO,ES,Federal Contract Tower,0,0,23,0,23,0,0,101,0,101,0,0,124,0,124,320,0,320,444
10/28/2022,OMN,FL,ASO,ES,Federal Contract Tower,0,0,21,0,21,0,0,31,0,31,0,0,52,0,52,24,0,24,76
10/29/2022,OMN,FL,ASO,ES,Federal Contract Tower,0,0,8,0,8,0,0,70,0,70,0,0,78,0,78,152,0,152,230
10/30/2022,OMN,FL,ASO,ES,Federal Contract Tower,0,0,8,0,8,0,0,15,0,15,0,0,23,0,23,4,0,4,27
10/31/2022,OMN,FL,ASO,ES,Federal Contract Tower,0,0,12,0,12,0,0,90,0,90,0,0,102,0,102,226,0,226,328
11/01/2022,OMN,FL,ASO,ES,Federal Contract Tower,0,0,26,0,26,0,0,129,0,129,0,0,155,0,155,238,0,238,393
11/02/2022,OMN,FL,ASO,ES,Federal Contract Tower,0,0,12,0,12,0,0,154,0,154,0,0,166,0,166,288,0,288,454
11/03/2022,OMN,FL,ASO,ES,Federal Contract Tower,0,0,16,0,16,0,0,126,0,126,0,0,142,0,142,310,0,310,452
11/04/2022,OMN,FL,ASO,ES,Federal Contract Tower,0,0,15,0,15,0,0,88,0,88,0,0,103,0,103,260,0,260,363
11/05/2022,OMN,FL,ASO,ES,Federal Contract Tower,0,0,11,0,11,0,0,56,0,56,0,0,67,0,67,80,0,80,147
11/06/2022,OMN,FL,ASO,ES,Federal Contract Tower,0,0,7,0,7,0,0,35,0,35,0,0,42,0,42,140,0,140,182
11/07/2022,OMN,FL,ASO,ES,Federal Contract Tower,0,0,6,0,6,0,0,69,0,69,0,0,75,0,75,164,0,164,239
11/08/2022,OMN,FL,ASO,ES,Federal Contract Tower,0,0,6,0,6,0,0,7,0,7,0,0,13,0,13,8,0,8,21
11/09/2022,OMN,FL,ASO,ES,Federal Contract Tower,0,0,0,0,0,0,0,0,0,0,0,0,0,0,0,0,0,0,0
11/11/2022,OMN,FL,ASO,ES,Federal Contract Tower,0,0,6,0,6,0,0,23,0,23,0,0,29,0,29,16,0,16,45
11/12/2022,OMN,FL,ASO,ES,Federal Contract Tower,0,0,15,0,15,0,0,106,0,106,0,0,121,0,121,194,0,194,315
11/13/2022,OMN,FL,ASO,ES,Federal Contract Tower,0,0,5,0,5,0,0,32,0,32,0,0,37,0,37,74,0,74,111
11/14/2022,OMN,FL,ASO,ES,Federal Contract Tower,0,0,14,0,14,0,0,158,0,158,0,0,172,0,172,254,0,254,426
11/15/2022,OMN,FL,ASO,ES,Federal Contract Tower,0,0,19,0,19,0,0,144,0,144,0,0,163,0,163,368,0,368,531
11/16/2022,OMN,FL,ASO,ES,Federal Contract Tower,0,0,22,0,22,0,0,16,0,16,0,0,38,0,38,30,0,30,68
11/17/2022,OMN,FL,ASO,ES,Federal Contract Tower,9,0,144,0,153,0,0,0,0,0,9,0,144,0,153,356,0,356,509
11/18/2022,OMN,FL,ASO,ES,Federal Contract Tower,0,0,16,0,16,0,0,188,0,188,0,0,204,0,204,400,0,400,604
11/19/2022,OMN,FL,ASO,ES,Federal Contract Tower,0,0,19,0,19,0,0,127,0,127,0,0,146,0,146,293,0,293,439
11/20/2022,OMN,FL,ASO,ES,Federal Contract Tower,0,0,6,0,6,0,0,25,0,25,0,0,31,0,31,76,0,76,107
11/21/2022,OMN,FL,ASO,ES,Federal Contract Tower,0,0,16,0,16,0,0,75,0,75,0,0,91,0,91,234,0,234,325
11/22/2022,OMN,FL,ASO,ES,Federal Contract Tower,0,0,7,0,7,0,0,0,0,0,0,0,7,0,7,0,0,0,7
11/23/2022,OMN,FL,ASO,ES,Federal Contract Tower,0,0,10,0,10,0,0,0,0,0,0,0,10,0,10,0,0,0,10
11/24/2022,OMN,FL,ASO,ES,Federal Contract Tower,0,0,0,0,0,0,0,2,0,2,0,0,2,0,2,0,0,0,2
11/25/2022,OMN,FL,ASO,ES,Federal Contract Tower,0,0,14,0,14,0,0,48,0,48,0,0,62,0,62,150,0,150,212
11/26/2022,OMN,FL,ASO,ES,Federal Contract Tower,0,0,32,0,32,0,0,29,0,29,0,0,61,0,61,64,0,64,125
11/27/2022,OMN,FL,ASO,ES,Federal Contract Tower,0,0,15,0,15,0,0,21,0,21,0,0,36,0,36,48,0,48,84
11/28/2022,OMN,FL,ASO,ES,Federal Contract Tower,0,0,10,0,10,0,0,161,0,161,0,0,171,0,171,302,0,302,473
11/29/2022,OMN,FL,ASO,ES,Federal Contract Tower,0,0,16,0,16,0,0,177,0,177,0,0,193,0,193,378,0,378,571
11/30/2022,OMN,FL,ASO,ES,Federal Contract Tower,0,0,4,0,4,0,0,151,0,151,0,0,155,0,155,222,0,222,377
12/01/2022,OMN,FL,ASO,ES,Federal Contract Tower,0,0,10,0,10,0,0,121,0,121,0,0,131,0,131,204,0,204,335
12/02/2022,OMN,FL,ASO,ES,Federal Contract Tower,0,0,14,0,14,0,0,133,0,133,0,0,147,0,147,380,0,380,527
12/03/2022,OMN,FL,ASO,ES,Federal Contract Tower,0,0,16,0,16,0,0,132,0,132,0,0,148,0,148,326,0,326,474
12/04/2022,OMN,FL,ASO,ES,Federal Contract Tower,0,0,8,0,8,0,0,46,0,46,0,0,54,0,54,162,0,162,216
12/05/2022,OMN,FL,ASO,ES,Federal Contract Tower,0,0,15,0,15,0,0,102,0,102,0,0,117,0,117,360,0,360,477
12/06/2022,OMN,FL,ASO,ES,Federal Contract Tower,0,0,20,0,20,0,0,205,0,205,0,0,225,0,225,356,0,356,581
12/07/2022,OMN,FL,ASO,ES,Federal Contract Tower,0,0,9,0,9,0,0,154,0,154,0,0,163,0,163,454,0,454,617
12/08/2022,OMN,FL,ASO,ES,Federal Contract Tower,0,0,22,0,22,0,0,159,0,159,0,0,181,0,181,348,0,348,529
12/09/2022,OMN,FL,ASO,ES,Federal Contract Tower,0,0,8,0,8,0,0,110,0,110,0,0,118,0,118,242,0,242,360
12/10/2022,OMN,FL,ASO,ES,Federal Contract Tower,0,0,9,0,9,0,0,25,0,25,0,0,34,0,34,48,0,48,82
12/11/2022,OMN,FL,ASO,ES,Federal Contract Tower,0,0,15,0,15,0,0,0,0,0,0,0,15,0,15,4,0,4,19
12/12/2022,OMN,FL,ASO,ES,Federal Contract Tower,0,0,17,0,17,0,0,97,0,97,0,0,114,0,114,376,0,376,490
12/13/2022,OMN,FL,ASO,ES,Federal Contract Tower,0,0,12,0,12,0,0,39,0,39,0,0,51,0,51,98,0,98,149
12/14/2022,OMN,FL,ASO,ES,Federal Contract Tower,0,0,16,0,16,0,0,171,0,171,0,0,187,0,187,308,0,308,495
12/15/2022,OMN,FL,ASO,ES,Federal Contract Tower,0,0,5,0,5,0,0,3,0,3,0,0,8,0,8,10,0,10,18
12/16/2022,OMN,FL,ASO,ES,Federal Contract Tower,0,0,15,0,15,0,0,156,0,156,0,0,171,0,171,306,0,306,477
12/17/2022,OMN,FL,ASO,ES,Federal Contract Tower,0,0,16,0,16,0,0,73,0,73,0,0,89,0,89,238,0,238,327
12/18/2022,OMN,FL,ASO,ES,Federal Contract Tower,0,0,4,0,4,0,0,63,0,63,0,0,67,0,67,177,0,177,244
12/19/2022,OMN,FL,ASO,ES,Federal Contract Tower,0,0,10,0,10,0,0,91,0,91,0,0,101,0,101,248,0,248,349
12/20/2022,OMN,FL,ASO,ES,Federal Contract Tower,0,0,4,0,4,0,0,47,0,47,0,0,51,0,51,124,0,124,175
12/21/2022,OMN,FL,ASO,ES,Federal Contract Tower,0,0,3,0,3,0,0,0,0,0,0,0,3,0,3,6,0,6,9
12/22/2022,OMN,FL,ASO,ES,Federal Contract Tower,0,0,9,0,9,0,0,22,0,22,0,0,31,0,31,55,0,55,86
12/23/2022,OMN,FL,ASO,ES,Federal Contract Tower,0,0,14,0,14,0,0,63,0,63,0,0,77,0,77,100,0,100,177
12/24/2022,OMN,FL,ASO,ES,Federal Contract Tower,0,0,2,0,2,0,0,36,0,36,0,0,38,0,38,96,0,96,134
12/25/2022,OMN,FL,ASO,ES,Federal Contract Tower,0,0,0,0,0,0,0,10,0,10,0,0,10,0,10,0,0,0,10
12/26/2022,OMN,FL,ASO,ES,Federal Contract Tower,0,0,2,0,2,0,0,39,0,39,0,0,41,0,41,4,0,4,45
12/27/2022,OMN,FL,ASO,ES,Federal Contract Tower,0,0,6,0,6,0,0,83,0,83,0,0,89,0,89,158,0,158,247
12/28/2022,OMN,FL,ASO,ES,Federal Contract Tower,0,0,9,0,9,0,0,118,0,118,0,0,127,0,127,164,0,164,291
12/29/2022,OMN,FL,ASO,ES,Federal Contract Tower,0,0,9,0,9,0,0,68,0,68,0,0,77,0,77,119,0,119,196
12/30/2022,OMN,FL,ASO,ES,Federal Contract Tower,0,0,7,0,7,0,0,54,0,54,0,0,61,0,61,70,0,70,131
12/31/2022,OMN,FL,ASO,ES,Federal Contract Tower,0,0,2,0,2,0,0,0,0,0,0,0,2,0,2,0,0,0,2
01/01/2023,OMN,FL,ASO,ES,Federal Contract Tower,0,0,1,0,1,0,0,13,0,13,0,0,14,0,14,8,0,8,22
01/02/2023,OMN,FL,ASO,ES,Federal Contract Tower,0,0,4,0,4,0,0,43,0,43,0,0,47,0,47,14,0,14,61
01/03/2023,OMN,FL,ASO,ES,Federal Contract Tower,0,0,17,0,17,0,0,31,0,31,0,0,48,0,48,132,0,132,180
01/04/2023,OMN,FL,ASO,ES,Federal Contract Tower,0,0,8,0,8,0,0,24,0,24,0,0,32,0,32,22,0,22,54
01/05/2023,OMN,FL,ASO,ES,Federal Contract Tower,0,0,4,0,4,0,0,30,0,30,0,0,34,0,34,94,0,94,128
01/06/2023,OMN,FL,ASO,ES,Federal Contract Tower,0,0,10,0,10,0,0,117,0,117,0,0,127,0,127,222,0,222,349
01/07/2023,OMN,FL,ASO,ES,Federal Contract Tower,0,0,12,0,12,0,0,117,0,117,0,0,129,0,129,264,0,264,393
01/08/2023,OMN,FL,ASO,ES,Federal Contract Tower,0,0,7,0,7,0,0,27,0,27,0,0,34,0,34,46,0,46,80
01/09/2023,OMN,FL,ASO,ES,Federal Contract Tower,0,0,11,0,11,0,0,108,0,108,0,0,119,0,119,290,0,290,409
01/10/2023,OMN,FL,ASO,ES,Federal Contract Tower,0,0,6,0,6,0,0,108,0,108,0,0,114,0,114,342,0,342,456
01/11/2023,OMN,FL,ASO,ES,Federal Contract Tower,0,0,14,0,14,0,0,169,0,169,0,0,183,0,183,306,0,306,489
01/12/2023,OMN,FL,ASO,ES,Federal Contract Tower,0,0,19,0,19,0,0,159,0,159,0,0,178,0,178,328,0,328,506
01/13/2023,OMN,FL,ASO,ES,Federal Contract Tower,0,0,9,0,9,0,0,2,0,2,0,0,11,0,11,4,0,4,15
01/14/2023,OMN,FL,ASO,ES,Federal Contract Tower,0,0,7,0,7,0,0,26,0,26,0,0,33,0,33,40,0,40,73
01/15/2023,OMN,FL,ASO,ES,Federal Contract Tower,0,0,7,0,7,0,0,44,0,44,0,0,51,0,51,148,0,148,199
01/16/2023,OMN,FL,ASO,ES,Federal Contract Tower,0,0,13,0,13,0,0,145,0,145,0,0,158,0,158,376,0,376,534
01/17/2023,OMN,FL,ASO,ES,Federal Contract Tower,0,0,6,0,6,0,0,107,0,107,0,0,113,0,113,272,0,272,385
01/18/2023,OMN,FL,ASO,ES,Federal Contract Tower,0,0,14,0,14,0,0,207,0,207,0,0,221,0,221,332,0,332,553
01/19/2023,OMN,FL,ASO,ES,Federal Contract Tower,0,0,7,0,7,0,0,107,0,107,0,0,114,0,114,228,0,228,342
01/20/2023,OMN,FL,ASO,ES,Federal Contract Tower,0,0,11,0,11,0,0,130,0,130,0,0,141,0,141,332,0,332,473
01/21/2023,OMN,FL,ASO,ES,Federal Contract Tower,0,0,14,0,14,0,0,111,0,111,0,0,125,0,125,228,0,228,353
01/22/2023,OMN,FL,ASO,ES,Federal Contract Tower,0,0,1,0,1,0,0,26,0,26,0,0,27,0,27,88,4,92,119
01/23/2023,OMN,FL,ASO,ES,Federal Contract Tower,0,0,6,0,6,0,0,72,0,72,0,0,78,0,78,326,0,326,404
01/24/2023,OMN,FL,ASO,ES,Federal Contract Tower,0,0,12,1,13,0,0,150,0,150,0,0,162,1,163,306,0,306,469
01/25/2023,OMN,FL,ASO,ES,Federal Contract Tower,0,0,2,0,2,0,0,92,0,92,0,0,94,0,94,122,0,122,216
01/26/2023,OMN,FL,ASO,ES,Federal Contract Tower,0,0,14,0,14,0,0,165,0,165,0,0,179,0,179,416,0,416,595
01/27/2023,OMN,FL,ASO,ES,Federal Contract Tower,0,0,22,0,22,0,0,143,0,143,0,0,165,0,165,312,0,312,477
01/28/2023,OMN,FL,ASO,ES,Federal Contract Tower,0,0,14,0,14,0,0,91,2,93,0,0,105,2,107,100,0,100,207
01/29/2023,OMN,FL,ASO,ES,Federal Contract Tower,0,0,7,0,7,0,0,80,0,80,0,0,87,0,87,190,0,190,277
01/30/2023,OMN,FL,ASO,ES,Federal Contract Tower,0,0,13,0,13,0,0,112,0,112,0,0,125,0,125,294,0,294,419
01/31/2023,OMN,FL,ASO,ES,Federal Contract Tower,0,0,19,0,19,0,0,110,0,110,0,0,129,0,129,272,0,272,401
02/01/2023,OMN,FL,ASO,ES,Federal Contract Tower,0,0,14,0,14,0,0,154,0,154,0,0,168,0,168,344,0,344,512
02/02/2023,OMN,FL,ASO,ES,Federal Contract Tower,0,0,18,0,18,0,0,168,0,168,0,0,186,0,186,386,0,386,572
02/03/2023,OMN,FL,ASO,ES,Federal Contract Tower,0,0,5,0,5,0,0,4,0,4,0,0,9,0,9,0,0,0,9
02/04/2023,OMN,FL,ASO,ES,Federal Contract Tower,0,0,14,0,14,0,0,62,0,62,0,0,76,0,76,76,0,76,152
02/05/2023,OMN,FL,ASO,ES,Federal Contract Tower,0,0,10,0,10,0,0,22,0,22,0,0,32,0,32,80,0,80,112
02/06/2023,OMN,FL,ASO,ES,Federal Contract Tower,0,0,12,0,12,0,0,156,0,156,0,0,168,0,168,348,0,348,516
02/07/2023,OMN,FL,ASO,ES,Federal Contract Tower,0,0,10,0,10,0,0,137,0,137,0,0,147,0,147,314,0,314,461
02/08/2023,OMN,FL,ASO,ES,Federal Contract Tower,0,0,16,0,16,0,0,169,0,169,0,0,185,0,185,308,0,308,493
02/09/2023,OMN,FL,ASO,ES,Federal Contract Tower,0,0,19,0,19,0,0,115,0,115,0,0,134,0,134,348,0,348,482
02/10/2023,OMN,FL,ASO,ES,Federal Contract Tower,0,0,13,0,13,0,0,145,0,145,0,0,158,0,158,180,0,180,338
02/11/2023,OMN,FL,ASO,ES,Federal Contract Tower,0,0,12,0,12,0,0,11,0,11,0,0,23,0,23,12,0,12,35
02/12/2023,OMN,FL,ASO,ES,Federal Contract Tower,0,0,2,0,2,0,0,3,0,3,0,0,5,0,5,2,0,2,7
02/13/2023,OMN,FL,ASO,ES,Federal Contract Tower,0,0,11,0,11,0,0,167,0,167,0,0,178,0,178,404,0,404,582
02/14/2023,OMN,FL,ASO,ES,Federal Contract Tower,0,0,15,0,15,0,0,163,0,163,0,0,178,0,178,400,0,400,578
02/15/2023,OMN,FL,ASO,ES,Federal Contract Tower,0,0,14,0,14,0,0,128,0,128,0,0,142,0,142,218,0,218,360
02/16/2023,OMN,FL,ASO,ES,Federal Contract Tower,0,0,17,0,17,0,0,126,0,126,0,0,143,0,143,368,0,368,511
02/17/2023,OMN,FL,ASO,ES,Federal Contract Tower,0,0,16,0,16,0,0,61,0,61,0,0,77,0,77,46,0,46,123
02/18/2023,OMN,FL,ASO,ES,Federal Contract Tower,0,0,4,0,4,0,0,85,0,85,0,0,89,0,89,46,0,46,135
02/19/2023,OMN,FL,ASO,ES,Federal Contract Tower,0,0,11,0,11,0,0,56,0,56,0,0,67,0,67,100,0,100,167
02/20/2023,OMN,FL,ASO,ES,Federal Contract Tower,0,0,10,0,10,0,0,128,0,128,0,0,138,0,138,362,0,362,500
02/21/2023,OMN,FL,ASO,ES,Federal Contract Tower,0,0,19,0,19,0,0,103,0,103,0,0,122,0,122,202,0,202,324
02/22/2023,OMN,FL,ASO,ES,Federal Contract Tower,0,0,8,0,8,0,0,145,0,145,0,0,153,0,153,282,0,282,435
02/23/2023,OMN,FL,ASO,ES,Federal Contract Tower,0,0,19,0,19,0,0,138,0,138,0,0,157,0,157,334,0,334,491
02/24/2023,OMN,FL,ASO,ES,Federal Contract Tower,0,0,19,0,19,0,0,109,0,109,0,0,128,0,128,308,0,308,436
02/25/2023,OMN,FL,ASO,ES,Federal Contract Tower,0,0,19,0,19,0,0,102,0,102,0,0,121,0,121,244,0,244,365
02/26/2023,OMN,FL,ASO,ES,Federal Contract Tower,0,0,11,0,11,0,0,79,0,79,0,0,90,0,90,192,0,192,282
02/27/2023,OMN,FL,ASO,ES,Federal Contract Tower,0,0,10,0,10,0,0,98,0,98,0,0,108,0,108,188,0,188,296
02/28/2023,OMN,FL,ASO,ES,Federal Contract Tower,0,0,7,0,7,0,0,51,0,51,0,0,58,0,58,122,0,122,180
03/01/2023,OMN,FL,ASO,ES,Federal Contract Tower,0,0,8,0,8,0,0,176,0,176,0,0,184,0,184,198,0,198,382
03/02/2023,OMN,FL,ASO,ES,Federal Contract Tower,0,0,21,0,21,0,0,153,0,153,0,0,174,0,174,280,0,280,454
03/03/2023,OMN,FL,ASO,ES,Federal Contract Tower,0,0,8,0,8,0,0,95,0,95,0,0,103,0,103,124,0,124,227
03/04/2023,OMN,FL,ASO,ES,Federal Contract Tower,0,0,7,0,7,0,0,82,0,82,0,0,89,0,89,80,0,80,169
03/05/2023,OMN,FL,ASO,ES,Federal Contract Tower,0,0,13,0,13,0,0,73,0,73,0,0,86,0,86,80,0,80,166
03/06/2023,OMN,FL,ASO,ES,Federal Contract Tower,0,0,12,0,12,0,0,123,0,123,0,0,135,0,135,360,0,360,495
03/07/2023,OMN,FL,ASO,ES,Federal Contract Tower,0,0,14,0,14,0,0,128,0,128,0,0,142,0,142,366,0,366,508
03/08/2023,OMN,FL,ASO,ES,Federal Contract Tower,0,0,7,0,7,0,0,28,0,28,0,0,35,0,35,86,0,86,121
03/09/2023,OMN,FL,ASO,ES,Federal Contract Tower,0,0,15,0,15,0,0,195,0,195,0,0,210,0,210,348,0,348,558
03/10/2023,OMN,FL,ASO,ES,Federal Contract Tower,0,0,11,0,11,0,0,102,0,102,0,0,113,0,113,196,0,196,309
03/11/2023,OMN,FL,ASO,ES,Federal Contract Tower,0,0,12,0,12,0,0,121,0,121,0,0,133,0,133,200,0,200,333
03/12/2023,OMN,FL,ASO,ES,Federal Contract Tower,0,0,11,0,11,0,0,56,0,56,0,0,67,0,67,70,0,70,137
03/13/2023,OMN,FL,ASO,ES,Federal Contract Tower,0,0,10,0,10,0,0,6,0,6,0,0,16,0,16,0,0,0,16
03/14/2023,OMN,FL,ASO,ES,Federal Contract Tower,0,0,28,0,28,0,0,180,0,180,0,0,208,0,208,454,0,454,662
03/15/2023,OMN,FL,ASO,ES,Federal Contract Tower,0,0,13,0,13,0,0,132,0,132,0,0,145,0,145,338,0,338,483
03/16/2023,OMN,FL,ASO,ES,Federal Contract Tower,0,0,6,0,6,0,0,124,0,124,0,0,130,0,130,412,0,412,542
03/17/2023,OMN,FL,ASO,ES,Federal Contract Tower,0,0,14,0,14,0,0,130,0,130,0,0,144,0,144,240,0,240,384
03/18/2023,OMN,FL,ASO,ES,Federal Contract Tower,0,0,2,0,2,0,0,50,0,50,0,0,52,0,52,72,0,72,124
03/19/2023,OMN,FL,ASO,ES,Federal Contract Tower,0,0,6,0,6,0,0,21,0,21,0,0,27,0,27,48,0,48,75
03/20/2023,OMN,FL,ASO,ES,Federal Contract Tower,0,0,10,0,10,0,0,138,0,138,0,0,148,0,148,382,0,382,530
03/21/2023,OMN,FL,ASO,ES,Federal Contract Tower,0,0,10,0,10,0,0,89,0,89,0,0,99,0,99,220,0,220,319
03/22/2023,OMN,FL,ASO,ES,Federal Contract Tower,0,0,15,0,15,0,0,117,0,117,0,0,132,0,132,280,0,280,412
03/23/2023,OMN,FL,ASO,ES,Federal Contract Tower,0,0,17,0,17,0,0,185,0,185,0,0,202,0,202,436,0,436,638
03/24/2023,OMN,FL,ASO,ES,Federal Contract Tower,0,0,10,0,10,0,0,133,0,133,0,0,143,0,143,464,0,464,607
03/25/2023,OMN,FL,ASO,ES,Federal Contract Tower,0,0,15,0,15,0,0,54,0,54,0,0,69,0,69,94,0,94,163
03/26/2023,OMN,FL,ASO,ES,Federal Contract Tower,0,0,10,0,10,0,0,37,0,37,0,0,47,0,47,148,0,148,195
03/27/2023,OMN,FL,ASO,ES,Federal Contract Tower,0,0,9,0,9,0,0,189,0,189,0,0,198,0,198,284,0,284,482
03/28/2023,OMN,FL,ASO,ES,Federal Contract Tower,0,0,13,0,13,0,0,100,0,100,0,0,113,0,113,142,0,142,255
03/29/2023,OMN,FL,ASO,ES,Federal Contract Tower,0,0,13,0,13,0,0,75,0,75,0,0,88,0,88,172,0,172,260
03/30/2023,OMN,FL,ASO,ES,Federal Contract Tower,0,0,10,0,10,0,0,139,0,139,0,0,149,0,149,320,0,320,469
03/31/2023,OMN,FL,ASO,ES,Federal Contract Tower,0,0,14,0,14,0,0,106,0,106,0,0,120,0,120,212,0,212,332
04/01/2023,OMN,FL,ASO,ES,Federal Contract Tower,0,0,8,0,8,0,0,101,0,101,0,0,109,0,109,162,0,162,271
04/02/2023,OMN,FL,ASO,ES,Federal Contract Tower,0,0,14,0,14,0,0,29,0,29,0,0,43,0,43,122,0,122,165
04/03/2023,OMN,FL,ASO,ES,Federal Contract Tower,0,0,13,0,13,0,0,87,0,87,0,0,100,0,100,230,0,230,330
04/04/2023,OMN,FL,ASO,ES,Federal Contract Tower,0,0,18,0,18,0,0,204,0,204,0,0,222,0,222,386,0,386,608
04/05/2023,OMN,FL,ASO,ES,Federal Contract Tower,0,0,7,0,7,0,0,115,0,115,0,0,122,0,122,216,0,216,338
04/06/2023,OMN,FL,ASO,ES,Federal Contract Tower,0,0,16,0,16,0,0,133,0,133,0,0,149,0,149,400,0,400,549
04/07/2023,OMN,FL,ASO,ES,Federal Contract Tower,0,0,18,0,18,0,0,136,0,136,0,0,154,0,154,400,0,400,554
04/08/2023,OMN,FL,ASO,ES,Federal Contract Tower,0,0,11,0,11,0,0,133,0,133,0,0,144,0,144,222,0,222,366
04/09/2023,OMN,FL,ASO,ES,Federal Contract Tower,0,0,2,0,2,0,0,0,0,0,0,0,2,0,2,0,0,0,2
04/10/2023,OMN,FL,ASO,ES,Federal Contract Tower,0,0,4,0,4,0,0,2,0,2,0,0,6,0,6,0,0,0,6
04/11/2023,OMN,FL,ASO,ES,Federal Contract Tower,0,0,9,0,9,0,0,26,0,26,0,0,35,0,35,44,0,44,79
04/12/2023,OMN,FL,ASO,ES,Federal Contract Tower,0,0,12,0,12,0,0,90,0,90,0,0,102,0,102,114,0,114,216
04/13/2023,OMN,FL,ASO,ES,Federal Contract Tower,0,0,7,0,7,0,0,35,0,35,0,0,42,0,42,112,0,112,154
04/14/2023,OMN,FL,ASO,ES,Federal Contract Tower,0,0,7,0,7,0,0,98,0,98,0,0,105,0,105,268,0,268,373
04/15/2023,OMN,FL,ASO,ES,Federal Contract Tower,0,0,10,0,10,0,0,173,0,173,0,0,183,0,183,368,0,368,551
04/16/2023,OMN,FL,ASO,ES,Federal Contract Tower,0,0,9,0,9,0,0,48,0,48,0,0,57,0,57,180,0,180,237
04/17/2023,OMN,FL,ASO,ES,Federal Contract Tower,0,0,15,0,15,0,0,88,0,88,0,0,103,0,103,324,0,324,427
04/18/2023,OMN,FL,ASO,ES,Federal Contract Tower,0,0,17,0,17,0,0,195,0,195,0,0,212,0,212,472,0,472,684
04/19/2023,OMN,FL,ASO,ES,Federal Contract Tower,0,0,10,0,10,0,0,144,0,144,0,0,154,0,154,398,0,398,552
04/20/2023,OMN,FL,ASO,ES,Federal Contract Tower,0,0,18,0,18,0,0,147,0,147,0,0,165,0,165,232,0,232,397
04/21/2023,OMN,FL,ASO,ES,Federal Contract Tower,0,0,11,0,11,0,0,114,0,114,0,0,125,0,125,248,0,248,373
04/22/2023,OMN,FL,ASO,ES,Federal Contract Tower,0,0,6,0,6,0,0,98,0,98,0,0,104,0,104,172,0,172,276
04/23/2023,OMN,FL,ASO,ES,Federal Contract Tower,0,0,10,0,10,0,0,22,0,22,0,0,32,0,32,82,0,82,114
04/24/2023,OMN,FL,ASO,ES,Federal Contract Tower,0,0,9,0,9,0,0,108,0,108,0,0,117,0,117,265,0,265,382
04/25/2023,OMN,FL,ASO,ES,Federal Contract Tower,0,0,17,0,17,0,0,125,0,125,0,0,142,0,142,216,0,216,358
04/26/2023,OMN,FL,ASO,ES,Federal Contract Tower,0,0,7,0,7,0,0,101,0,101,0,0,108,0,108,336,0,336,444
04/27/2023,OMN,FL,ASO,ES,Federal Contract Tower,0,0,13,0,13,0,0,63,0,63,0,0,76,0,76,194,0,194,270
04/28/2023,OMN,FL,ASO,ES,Federal Contract Tower,0,0,16,0,16,0,0,107,0,107,0,0,123,0,123,190,0,190,313
04/29/2023,OMN,FL,ASO,ES,Federal Contract Tower,0,0,20,0,20,0,0,148,0,148,0,0,168,0,168,232,0,232,400
04/30/2023,OMN,FL,ASO,ES,Federal Contract Tower,0,0,6,0,6,0,0,1,0,1,0,0,7,0,7,0,0,0,7
05/01/2023,OMN,FL,ASO,ES,Federal Contract Tower,0,0,7,0,7,0,0,107,0,107,0,0,114,0,114,204,0,204,318
05/02/2023,OMN,FL,ASO,ES,Federal Contract Tower,0,0,10,0,10,0,0,126,0,126,0,0,136,0,136,224,0,224,360
05/03/2023,OMN,FL,ASO,ES,Federal Contract Tower,0,0,9,0,9,0,0,64,0,64,0,0,73,0,73,192,0,192,265
05/04/2023,OMN,FL,ASO,ES,Federal Contract Tower,0,0,19,0,19,0,0,133,0,133,0,0,152,0,152,390,0,390,542
05/05/2023,OMN,FL,ASO,ES,Federal Contract Tower,0,0,11,0,11,0,0,138,0,138,0,0,149,0,149,399,0,399,548
05/06/2023,OMN,FL,ASO,ES,Federal Contract Tower,0,0,10,0,10,0,0,25,0,25,0,0,35,0,35,74,0,74,109
05/07/2023,OMN,FL,ASO,ES,Federal Contract Tower,0,0,6,0,6,0,0,59,0,59,0,0,65,0,65,130,0,130,195
05/08/2023,OMN,FL,ASO,ES,Federal Contract Tower,0,0,12,0,12,0,0,133,0,133,0,0,145,0,145,234,0,234,379
05/09/2023,OMN,FL,ASO,ES,Federal Contract Tower,0,0,11,0,11,0,0,121,0,121,0,0,132,0,132,284,0,284,416
05/10/2023,OMN,FL,ASO,ES,Federal Contract Tower,0,0,8,0,8,0,0,103,0,103,0,0,111,0,111,96,0,96,207
05/11/2023,OMN,FL,ASO,ES,Federal Contract Tower,0,0,14,0,14,0,0,102,0,102,0,0,116,0,116,214,0,214,330
05/12/2023,OMN,FL,ASO,ES,Federal Contract Tower,0,0,14,0,14,0,0,111,0,111,0,0,125,0,125,0,0,0,125
05/13/2023,OMN,FL,ASO,ES,Federal Contract Tower,0,0,9,0,9,0,0,98,0,98,0,0,107,0,107,164,0,164,271
05/14/2023,OMN,FL,ASO,ES,Federal Contract Tower,0,0,12,0,12,0,0,76,0,76,0,0,88,0,88,146,0,146,234
05/15/2023,OMN,FL,ASO,ES,Federal Contract Tower,0,0,15,0,15,0,0,136,0,136,0,0,151,0,151,0,0,0,151
05/16/2023,OMN,FL,ASO,ES,Federal Contract Tower,0,0,19,0,19,0,0,98,0,98,0,0,117,0,117,242,0,242,359
05/17/2023,OMN,FL,ASO,ES,Federal Contract Tower,0,0,10,0,10,0,0,117,0,117,0,0,127,0,127,260,2,262,389
05/18/2023,OMN,FL,ASO,ES,Federal Contract Tower,0,0,9,0,9,0,0,86,0,86,0,0,95,0,95,258,0,258,353
05/19/2023,OMN,FL,ASO,ES,Federal Contract Tower,0,0,16,0,16,0,0,70,0,70,0,0,86,0,86,164,0,164,250
05/20/2023,OMN,FL,ASO,ES,Federal Contract Tower,0,0,16,0,16,0,0,50,0,50,0,0,66,0,66,124,0,124,190
05/21/2023,OMN,FL,ASO,ES,Federal Contract Tower,0,0,8,0,8,0,0,41,0,41,0,0,49,0,49,33,0,33,82
05/22/2023,OMN,FL,ASO,ES,Federal Contract Tower,0,0,3,0,3,0,0,38,0,38,0,0,41,0,41,74,0,74,115
05/23/2023,OMN,FL,ASO,ES,Federal Contract Tower,0,0,8,0,8,0,0,79,0,79,0,0,87,0,87,146,0,146,233
05/24/2023,OMN,FL,ASO,ES,Federal Contract Tower,0,0,7,0,7,0,0,14,0,14,0,0,21,0,21,24,0,24,45
05/25/2023,OMN,FL,ASO,ES,Federal Contract Tower,0,0,8,0,8,0,0,63,0,63,0,0,71,0,71,136,0,136,207
05/26/2023,OMN,FL,ASO,ES,Federal Contract Tower,0,0,4,0,4,0,0,8,0,8,0,0,12,0,12,94,0,94,106
05/27/2023,OMN,FL,ASO,ES,Federal Contract Tower,0,0,15,0,15,0,0,131,0,131,0,0,146,0,146,224,0,224,370
05/28/2023,OMN,FL,ASO,ES,Federal Contract Tower,0,0,6,0,6,0,0,100,0,100,0,0,106,0,106,262,0,262,368
05/29/2023,OMN,FL,ASO,ES,Federal Contract Tower,0,0,13,0,13,0,0,133,0,133,0,0,146,0,146,262,0,262,408
05/30/2023,OMN,FL,ASO,ES,Federal Contract Tower,0,0,7,0,7,0,0,142,0,142,0,0,149,0,149,262,0,262,411
05/31/2023,OMN,FL,ASO,ES,Federal Contract Tower,0,0,13,0,13,0,0,133,0,133,0,0,146,0,146,236,0,236,382
06/01/2023,OMN,FL,ASO,ES,Federal Contract Tower,0,0,15,0,15,0,0,137,0,137,0,0,152,0,152,244,0,244,396
06/02/2023,OMN,FL,ASO,ES,Federal Contract Tower,0,0,12,0,12,0,0,43,0,43,0,0,55,0,55,68,0,68,123
06/03/2023,OMN,FL,ASO,ES,Federal Contract Tower,0,0,7,0,7,0,0,67,0,67,0,0,74,0,74,136,0,136,210
06/04/2023,OMN,FL,ASO,ES,Federal Contract Tower,0,0,2,0,2,0,0,63,0,63,0,0,65,0,65,144,0,144,209
06/05/2023,OMN,FL,ASO,ES,Federal Contract Tower,0,0,11,0,11,0,0,39,0,39,0,0,50,0,50,104,0,104,154
06/06/2023,OMN,FL,ASO,ES,Federal Contract Tower,0,0,16,0,16,0,0,171,0,171,0,0,187,0,187,314,0,314,501
06/07/2023,OMN,FL,ASO,ES,Federal Contract Tower,0,0,8,0,8,0,0,111,0,111,0,0,119,0,119,176,0,176,295
06/08/2023,OMN,FL,ASO,ES,Federal Contract Tower,0,0,11,0,11,0,0,173,0,173,0,0,184,0,184,334,0,334,518
06/09/2023,OMN,FL,ASO,ES,Federal Contract Tower,0,0,7,0,7,0,0,142,0,142,0,0,149,0,149,270,0,270,419
06/10/2023,OMN,FL,ASO,ES,Federal Contract Tower,0,0,13,0,13,0,0,88,0,88,0,0,101,0,101,102,0,102,203
06/11/2023,OMN,FL,ASO,ES,Federal Contract Tower,0,0,7,0,7,0,0,65,0,65,0,0,72,0,72,148,0,148,220
06/12/2023,OMN,FL,ASO,ES,Federal Contract Tower,0,0,17,0,17,0,0,141,0,141,0,0,158,0,158,318,0,318,476
06/13/2023,OMN,FL,ASO,ES,Federal Contract Tower,0,0,11,0,11,0,0,130,0,130,0,0,141,0,141,374,0,374,515
06/14/2023,OMN,FL,ASO,ES,Federal Contract Tower,0,0,10,0,10,0,0,172,0,172,0,0,182,0,182,264,0,264,446
06/15/2023,OMN,FL,ASO,ES,Federal Contract Tower,0,0,7,0,7,0,0,104,0,104,0,0,111,0,111,140,0,140,251
06/16/2023,OMN,FL,ASO,ES,Federal Contract Tower,0,0,5,0,5,0,0,24,0,24,0,0,29,0,29,16,0,16,45
06/17/2023,OMN,FL,ASO,ES,Federal Contract Tower,0,0,9,0,9,0,0,71,0,71,0,0,80,0,80,122,0,122,202
06/18/2023,OMN,FL,ASO,ES,Federal Contract Tower,0,0,7,0,7,0,0,29,0,29,0,0,36,0,36,82,0,82,118
06/19/2023,OMN,FL,ASO,ES,Federal Contract Tower,0,0,16,0,16,0,0,118,0,118,0,0,134,0,134,282,0,282,416
06/20/2023,OMN,FL,ASO,ES,Federal Contract Tower,0,0,2,0,2,0,0,12,0,12,0,0,14,0,14,6,0,6,20
06/21/2023,OMN,FL,ASO,ES,Federal Contract Tower,0,0,9,0,9,0,0,78,0,78,0,0,87,0,87,82,0,82,169
06/22/2023,OMN,FL,ASO,ES,Federal Contract Tower,0,0,12,0,12,0,0,113,0,113,0,0,125,0,125,254,0,254,379
06/23/2023,OMN,FL,ASO,ES,Federal Contract Tower,0,0,9,0,9,0,0,53,0,53,0,0,62,0,62,116,0,116,178
06/24/2023,OMN,FL,ASO,ES,Federal Contract Tower,0,0,13,0,13,0,0,106,0,106,0,0,119,0,119,178,0,178,297
06/25/2023,OMN,FL,ASO,ES,Federal Contract Tower,0,0,10,0,10,0,0,73,0,73,0,0,83,0,83,66,0,66,149
06/26/2023,OMN,FL,ASO,ES,Federal Contract Tower,0,0,11,0,11,0,0,166,0,166,0,0,177,0,177,240,0,240,417
06/27/2023,OMN,FL,ASO,ES,Federal Contract Tower,0,0,9,0,9,0,0,134,0,134,0,0,143,0,143,296,0,296,439
06/28/2023,OMN,FL,ASO,ES,Federal Contract Tower,0,0,10,0,10,0,0,112,0,112,0,0,122,0,122,186,0,186,308
06/29/2023,OMN,FL,ASO,ES,Federal Contract Tower,0,0,8,0,8,0,0,174,0,174,0,0,182,0,182,238,0,238,420
06/30/2023,OMN,FL,ASO,ES,Federal Contract Tower,0,0,14,0,14,0,0,106,0,106,0,0,120,0,120,138,0,138,258
07/01/2023,OMN,FL,ASO,ES,Federal Contract Tower,0,0,4,0,4,0,0,119,0,119,0,0,123,0,123,162,0,162,285
07/02/2023,OMN,FL,ASO,ES,Federal Contract Tower,0,0,5,0,5,0,0,51,0,51,0,0,56,0,56,80,0,80,136
07/03/2023,OMN,FL,ASO,ES,Federal Contract Tower,0,0,9,0,9,0,0,102,0,102,0,0,111,0,111,306,0,306,417
07/04/2023,OMN,FL,ASO,ES,Federal Contract Tower,0,0,0,0,0,0,0,32,0,32,0,0,32,0,32,84,0,84,116
07/05/2023,OMN,FL,ASO,ES,Federal Contract Tower,0,0,9,0,9,0,0,67,0,67,0,0,76,0,76,140,0,140,216
07/06/2023,OMN,FL,ASO,ES,Federal Contract Tower,0,0,8,0,8,0,0,78,0,78,0,0,86,0,86,246,0,246,332
07/07/2023,OMN,FL,ASO,ES,Federal Contract Tower,0,0,6,0,6,0,0,70,0,70,0,0,76,0,76,220,0,220,296
07/08/2023,OMN,FL,ASO,ES,Federal Contract Tower,0,0,12,0,12,0,0,62,0,62,0,0,74,0,74,58,0,58,132
07/09/2023,OMN,FL,ASO,ES,Federal Contract Tower,0,0,4,0,4,0,0,38,0,38,0,0,42,0,42,136,0,136,178
07/10/2023,OMN,FL,ASO,ES,Federal Contract Tower,0,0,5,0,5,0,0,67,0,67,0,0,72,0,72,220,0,220,292
07/11/2023,OMN,FL,ASO,ES,Federal Contract Tower,0,0,7,0,7,0,0,56,0,56,0,0,63,0,63,112,0,112,175
07/12/2023,OMN,FL,ASO,ES,Federal Contract Tower,0,0,7,0,7,0,0,124,0,124,0,0,131,0,131,270,0,270,401
07/13/2023,OMN,FL,ASO,ES,Federal Contract Tower,0,0,17,0,17,0,0,123,0,123,0,0,140,0,140,348,0,348,488
07/14/2023,OMN,FL,ASO,ES,Federal Contract Tower,0,0,6,0,6,0,0,92,0,92,0,0,98,0,98,320,0,320,418
07/15/2023,OMN,FL,ASO,ES,Federal Contract Tower,0,0,21,0,21,0,0,103,0,103,0,0,124,0,124,282,0,282,406
07/16/2023,OMN,FL,ASO,ES,Federal Contract Tower,0,0,7,0,7,0,0,17,0,17,0,0,24,0,24,86,0,86,110
07/17/2023,OMN,FL,ASO,ES,Federal Contract Tower,0,0,10,0,10,0,0,57,0,57,0,0,67,0,67,142,0,142,209
07/18/2023,OMN,FL,ASO,ES,Federal Contract Tower,0,0,13,0,13,0,0,92,0,92,0,0,105,0,105,198,0,198,303
07/19/2023,OMN,FL,ASO,ES,Federal Contract Tower,0,0,19,0,19,0,0,128,0,128,0,0,147,0,147,266,0,266,413
07/20/2023,OMN,FL,ASO,ES,Federal Contract Tower,0,0,19,0,19,0,0,121,0,121,0,0,140,0,140,310,0,310,450
07/21/2023,OMN,FL,ASO,ES,Federal Contract Tower,0,0,16,0,16,0,0,135,0,135,0,0,151,0,151,270,0,270,421
07/22/2023,OMN,FL,ASO,ES,Federal Contract Tower,0,0,6,0,6,0,0,98,0,98,0,0,104,0,104,124,0,124,228
07/23/2023,OMN,FL,ASO,ES,Federal Contract Tower,0,0,9,0,9,0,0,37,0,37,0,0,46,0,46,83,0,83,129
07/24/2023,OMN,FL,ASO,ES,Federal Contract Tower,0,0,8,0,8,0,0,96,0,96,0,0,104,0,104,202,0,202,306
07/25/2023,OMN,FL,ASO,ES,Federal Contract Tower,0,0,17,0,17,0,0,107,0,107,0,0,124,0,124,226,0,226,350
07/26/2023,OMN,FL,ASO,ES,Federal Contract Tower,0,0,15,0,15,0,0,140,0,140,0,0,155,0,155,238,0,238,393
07/27/2023,OMN,FL,ASO,ES,Federal Contract Tower,0,0,11,0,11,0,0,54,0,54,0,0,65,0,65,122,0,122,187
07/28/2023,OMN,FL,ASO,ES,Federal Contract Tower,0,0,14,0,14,0,0,36,0,36,0,0,50,0,50,74,0,74,124
07/29/2023,OMN,FL,ASO,ES,Federal Contract Tower,0,0,17,0,17,0,0,78,0,78,0,0,95,0,95,194,0,194,289
07/30/2023,OMN,FL,ASO,ES,Federal Contract Tower,0,0,5,0,5,0,0,57,0,57,0,0,62,0,62,108,0,108,170
07/31/2023,OMN,FL,ASO,ES,Federal Contract Tower,0,0,10,0,10,0,0,135,0,135,0,0,145,0,145,210,0,210,355
08/01/2023,OMN,FL,ASO,ES,Federal Contract Tower,0,0,12,0,12,0,0,133,0,133,0,0,145,0,145,196,0,196,341
08/02/2023,OMN,FL,ASO,ES,Federal Contract Tower,0,0,8,0,8,0,0,131,0,131,0,0,139,0,139,218,0,218,357
08/03/2023,OMN,FL,ASO,ES,Federal Contract Tower,0,0,7,0,7,0,0,145,0,145,0,0,152,0,152,338,0,338,490
08/04/2023,OMN,FL,ASO,ES,Federal Contract Tower,0,0,6,0,6,0,0,144,0,144,0,0,150,0,150,178,0,178,328
08/05/2023,OMN,FL,ASO,ES,Federal Contract Tower,0,0,9,0,9,0,0,112,0,112,0,0,121,0,121,196,0,196,317
08/06/2023,OMN,FL,ASO,ES,Federal Contract Tower,0,0,7,0,7,0,0,46,0,46,0,0,53,0,53,132,0,132,185
08/07/2023,OMN,FL,ASO,ES,Federal Contract Tower,0,0,5,0,5,0,0,175,0,175,0,0,180,0,180,306,0,306,486
08/08/2023,OMN,FL,ASO,ES,Federal Contract Tower,0,0,9,0,9,0,0,116,0,116,0,0,125,0,125,222,0,222,347
08/09/2023,OMN,FL,ASO,ES,Federal Contract Tower,0,0,9,0,9,0,0,137,0,137,0,0,146,0,146,192,0,192,338
08/10/2023,OMN,FL,ASO,ES,Federal Contract Tower,0,0,13,0,13,0,0,157,0,157,0,0,170,0,170,346,0,346,516
08/11/2023,OMN,FL,ASO,ES,Federal Contract Tower,0,0,8,0,8,0,0,105,0,105,0,0,113,0,113,352,0,352,465
08/12/2023,OMN,FL,ASO,ES,Federal Contract Tower,0,0,6,0,6,0,0,68,0,68,0,0,74,0,74,150,0,150,224
08/13/2023,OMN,FL,ASO,ES,Federal Contract Tower,0,0,6,0,6,0,0,30,0,30,0,0,36,0,36,38,0,38,74
08/14/2023,OMN,FL,ASO,ES,Federal Contract Tower,0,0,5,0,5,0,0,80,0,80,0,0,85,0,85,204,0,204,289
08/15/2023,OMN,FL,ASO,ES,Federal Contract Tower,0,0,6,0,6,0,0,95,0,95,0,0,101,0,101,248,0,248,349
08/16/2023,OMN,FL,ASO,ES,Federal Contract Tower,0,0,10,0,10,0,0,98,0,98,0,0,108,0,108,248,0,248,356
08/18/2023,OMN,FL,ASO,ES,Federal Contract Tower,0,0,11,0,11,0,0,108,0,108,0,0,119,0,119,104,0,104,223
08/19/2023,OMN,FL,ASO,ES,Federal Contract Tower,0,0,9,0,9,0,0,125,0,125,0,0,134,0,134,142,0,142,276
08/20/2023,OMN,FL,ASO,ES,Federal Contract Tower,0,0,8,0,8,0,0,41,0,41,0,0,49,0,49,44,0,44,93
08/21/2023,OMN,FL,ASO,ES,Federal Contract Tower,0,0,13,0,13,0,0,100,0,100,0,0,113,0,113,214,0,214,327
08/22/2023,OMN,FL,ASO,ES,Federal Contract Tower,0,0,11,0,11,0,0,149,0,149,0,0,160,0,160,274,0,274,434
08/23/2023,OMN,FL,ASO,ES,Federal Contract Tower,0,0,15,0,15,0,0,169,0,169,0,0,184,0,184,258,0,258,442
08/24/2023,OMN,FL,ASO,ES,Federal Contract Tower,0,0,16,0,16,0,0,145,0,145,0,0,161,0,161,230,0,230,391
08/25/2023,OMN,FL,ASO,ES,Federal Contract Tower,0,0,12,0,12,0,0,89,0,89,0,0,101,0,101,238,0,238,339
08/26/2023,OMN,FL,ASO,ES,Federal Contract Tower,0,0,1,0,1,0,0,79,0,79,0,0,80,0,80,100,0,100,180
08/27/2023,OMN,FL,ASO,ES,Federal Contract Tower,0,0,4,0,4,0,0,34,0,34,0,0,38,0,38,62,0,62,100
08/28/2023,OMN,FL,ASO,ES,Federal Contract Tower,0,0,10,0,10,0,0,58,0,58,0,0,68,0,68,112,0,112,180
08/29/2023,OMN,FL,ASO,ES,Federal Contract Tower,0,0,3,0,3,0,0,54,0,54,0,0,57,0,57,106,0,106,163
08/30/2023,OMN,FL,ASO,ES,Federal Contract Tower,0,0,0,0,0,0,0,0,0,0,0,0,0,0,0,0,0,0,0
08/31/2023,OMN,FL,ASO,ES,Federal Contract Tower,0,0,8,0,8,0,0,75,0,75,0,0,83,0,83,82,0,82,165
