01/01/2020,WHP,CA,AWP,WE,Federal Contract Tower,0,0,0,0,0,0,0,93,0,93,0,0,93,0,93,64,0,64,157
01/02/2020,WHP,CA,AWP,WE,Federal Contract Tower,0,0,0,0,0,0,0,104,0,104,0,0,104,0,104,146,0,146,250
01/03/2020,WHP,CA,AWP,WE,Federal Contract Tower,0,0,0,0,0,0,0,122,0,122,0,0,122,0,122,192,0,192,314
01/04/2020,WHP,CA,AWP,WE,Federal Contract Tower,0,0,3,0,3,0,0,132,0,132,0,0,135,0,135,172,0,172,307
01/05/2020,WHP,CA,AWP,WE,Federal Contract Tower,0,0,2,0,2,0,0,72,0,72,0,0,74,0,74,112,0,112,186
01/06/2020,WHP,CA,AWP,WE,Federal Contract Tower,0,0,0,0,0,0,0,63,0,63,0,0,63,0,63,172,0,172,235
01/07/2020,WHP,CA,AWP,WE,Federal Contract Tower,0,0,0,0,0,0,0,98,0,98,0,0,98,0,98,110,0,110,208
01/08/2020,WHP,CA,AWP,WE,Federal Contract Tower,0,0,0,0,0,0,0,101,0,101,0,0,101,0,101,196,0,196,297
01/09/2020,WHP,CA,AWP,WE,Federal Contract Tower,0,0,0,0,0,0,0,74,0,74,0,0,74,0,74,94,0,94,168
01/10/2020,WHP,CA,AWP,WE,Federal Contract Tower,0,0,1,0,1,0,0,175,0,175,0,0,176,0,176,248,0,248,424
01/11/2020,WHP,CA,AWP,WE,Federal Contract Tower,0,0,0,0,0,0,0,137,0,137,0,0,137,0,137,236,0,236,373
01/12/2020,WHP,CA,AWP,WE,Federal Contract Tower,0,0,2,0,2,0,0,171,0,171,0,0,173,0,173,222,0,222,395
01/13/2020,WHP,CA,AWP,WE,Federal Contract Tower,0,0,2,0,2,0,0,69,0,69,0,0,71,0,71,98,0,98,169
01/14/2020,WHP,CA,AWP,WE,Federal Contract Tower,0,0,0,0,0,0,0,97,0,97,0,0,97,0,97,134,0,134,231
01/15/2020,WHP,CA,AWP,WE,Federal Contract Tower,0,0,0,0,0,0,0,156,0,156,0,0,156,0,156,186,0,186,342
01/16/2020,WHP,CA,AWP,WE,Federal Contract Tower,0,0,3,0,3,0,0,36,0,36,0,0,39,0,39,94,0,94,133
01/17/2020,WHP,CA,AWP,WE,Federal Contract Tower,0,0,1,0,1,0,0,147,0,147,0,0,148,0,148,220,0,220,368
01/18/2020,WHP,CA,AWP,WE,Federal Contract Tower,0,0,1,0,1,0,0,152,0,152,0,0,153,0,153,138,0,138,291
01/19/2020,WHP,CA,AWP,WE,Federal Contract Tower,0,0,1,0,1,0,0,113,0,113,0,0,114,0,114,216,0,216,330
01/20/2020,WHP,CA,AWP,WE,Federal Contract Tower,0,0,0,0,0,0,0,81,0,81,0,0,81,0,81,200,0,200,281
01/21/2020,WHP,CA,AWP,WE,Federal Contract Tower,0,0,6,0,6,0,0,64,0,64,0,0,70,0,70,134,0,134,204
01/22/2020,WHP,CA,AWP,WE,Federal Contract Tower,0,0,0,0,0,0,0,106,0,106,0,0,106,0,106,174,0,174,280
01/23/2020,WHP,CA,AWP,WE,Federal Contract Tower,0,0,1,0,1,0,0,126,0,126,0,0,127,0,127,76,0,76,203
01/24/2020,WHP,CA,AWP,WE,Federal Contract Tower,0,0,2,0,2,0,0,140,0,140,0,0,142,0,142,126,0,126,268
01/25/2020,WHP,CA,AWP,WE,Federal Contract Tower,0,0,0,0,0,0,0,205,0,205,0,0,205,0,205,202,0,202,407
01/26/2020,WHP,CA,AWP,WE,Federal Contract Tower,0,0,10,0,10,0,0,36,0,36,0,0,46,0,46,60,0,60,106
01/27/2020,WHP,CA,AWP,WE,Federal Contract Tower,0,0,2,0,2,0,0,46,0,46,0,0,48,0,48,36,0,36,84
01/28/2020,WHP,CA,AWP,WE,Federal Contract Tower,0,0,1,0,1,0,0,68,0,68,0,0,69,0,69,54,0,54,123
01/29/2020,WHP,CA,AWP,WE,Federal Contract Tower,0,0,0,0,0,0,0,33,0,33,0,0,33,0,33,4,0,4,37
01/30/2020,WHP,CA,AWP,WE,Federal Contract Tower,0,0,0,0,0,0,0,119,0,119,0,0,119,0,119,132,0,132,251
01/31/2020,WHP,CA,AWP,WE,Federal Contract Tower,0,0,0,0,0,0,0,111,0,111,0,0,111,0,111,68,0,68,179
02/01/2020,WHP,CA,AWP,WE,Federal Contract Tower,0,0,2,0,2,0,0,170,0,170,0,0,172,0,172,156,0,156,328
02/02/2020,WHP,CA,AWP,WE,Federal Contract Tower,0,0,1,0,1,0,0,103,0,103,0,0,104,0,104,108,0,108,212
02/03/2020,WHP,CA,AWP,WE,Federal Contract Tower,0,0,0,0,0,0,0,17,0,17,0,0,17,0,17,2,0,2,19
02/04/2020,WHP,CA,AWP,WE,Federal Contract Tower,0,0,0,0,0,0,0,19,0,19,0,0,19,0,19,10,0,10,29
02/05/2020,WHP,CA,AWP,WE,Federal Contract Tower,0,0,2,0,2,0,0,114,0,114,0,0,116,0,116,118,0,118,234
02/06/2020,WHP,CA,AWP,WE,Federal Contract Tower,0,0,0,0,0,0,0,145,0,145,0,0,145,0,145,138,0,138,283
02/07/2020,WHP,CA,AWP,WE,Federal Contract Tower,0,0,1,0,1,0,0,189,0,189,0,0,190,0,190,264,0,264,454
02/08/2020,WHP,CA,AWP,WE,Federal Contract Tower,0,0,0,0,0,0,0,220,0,220,0,0,220,0,220,274,0,274,494
02/09/2020,WHP,CA,AWP,WE,Federal Contract Tower,0,0,5,0,5,0,0,23,0,23,0,0,28,0,28,60,0,60,88
02/10/2020,WHP,CA,AWP,WE,Federal Contract Tower,0,0,0,0,0,0,0,29,0,29,0,0,29,0,29,0,0,0,29
02/11/2020,WHP,CA,AWP,WE,Federal Contract Tower,0,0,0,0,0,0,0,35,0,35,0,0,35,0,35,26,0,26,61
02/12/2020,WHP,CA,AWP,WE,Federal Contract Tower,0,0,0,0,0,0,0,142,0,142,0,0,142,0,142,184,0,184,326
02/13/2020,WHP,CA,AWP,WE,Federal Contract Tower,0,0,1,0,1,0,0,139,0,139,0,0,140,0,140,156,0,156,296
02/14/2020,WHP,CA,AWP,WE,Federal Contract Tower,0,0,0,0,0,0,0,178,0,178,0,0,178,0,178,224,0,224,402
02/15/2020,WHP,CA,AWP,WE,Federal Contract Tower,0,0,4,0,4,0,0,153,0,153,0,0,157,0,157,156,0,156,313
02/16/2020,WHP,CA,AWP,WE,Federal Contract Tower,0,0,1,0,1,0,0,127,0,127,0,0,128,0,128,160,0,160,288
02/17/2020,WHP,CA,AWP,WE,Federal Contract Tower,0,0,0,0,0,0,0,141,0,141,0,0,141,0,141,136,0,136,277
02/18/2020,WHP,CA,AWP,WE,Federal Contract Tower,0,0,2,0,2,0,0,61,0,61,0,0,63,0,63,96,0,96,159
02/19/2020,WHP,CA,AWP,WE,Federal Contract Tower,0,0,1,0,1,0,0,100,0,100,0,0,101,0,101,106,0,106,207
02/20/2020,WHP,CA,AWP,WE,Federal Contract Tower,0,0,0,0,0,0,0,130,0,130,0,0,130,0,130,104,0,104,234
02/21/2020,WHP,CA,AWP,WE,Federal Contract Tower,0,0,0,0,0,0,0,142,0,142,0,0,142,0,142,226,0,226,368
02/22/2020,WHP,CA,AWP,WE,Federal Contract Tower,0,0,2,0,2,0,0,62,0,62,0,0,64,0,64,166,0,166,230
02/23/2020,WHP,CA,AWP,WE,Federal Contract Tower,0,0,0,0,0,0,0,120,0,120,0,0,120,0,120,146,0,146,266
02/24/2020,WHP,CA,AWP,WE,Federal Contract Tower,0,0,2,0,2,0,0,95,0,95,0,0,97,0,97,160,0,160,257
02/25/2020,WHP,CA,AWP,WE,Federal Contract Tower,0,0,0,0,0,0,0,49,0,49,0,0,49,0,49,42,0,42,91
02/26/2020,WHP,CA,AWP,WE,Federal Contract Tower,0,0,0,0,0,0,0,81,0,81,0,0,81,0,81,42,0,42,123
02/27/2020,WHP,CA,AWP,WE,Federal Contract Tower,0,0,0,0,0,0,0,129,0,129,0,0,129,0,129,142,0,142,271
02/28/2020,WHP,CA,AWP,WE,Federal Contract Tower,0,0,2,0,2,0,0,147,0,147,0,0,149,0,149,116,0,116,265
02/29/2020,WHP,CA,AWP,WE,Federal Contract Tower,0,0,3,0,3,0,0,162,0,162,0,0,165,0,165,180,0,180,345
03/01/2020,WHP,CA,AWP,WE,Federal Contract Tower,0,0,1,0,1,0,0,37,0,37,0,0,38,0,38,94,0,94,132
03/02/2020,WHP,CA,AWP,WE,Federal Contract Tower,0,0,0,0,0,0,0,29,0,29,0,0,29,0,29,2,0,2,31
03/03/2020,WHP,CA,AWP,WE,Federal Contract Tower,0,0,1,0,1,0,0,86,0,86,0,0,87,0,87,104,0,104,191
03/04/2020,WHP,CA,AWP,WE,Federal Contract Tower,0,0,0,0,0,0,0,106,0,106,0,0,106,0,106,160,0,160,266
03/05/2020,WHP,CA,AWP,WE,Federal Contract Tower,0,0,0,0,0,0,0,153,0,153,0,0,153,0,153,274,0,274,427
03/06/2020,WHP,CA,AWP,WE,Federal Contract Tower,0,0,0,0,0,0,0,162,0,162,0,0,162,0,162,190,0,190,352
03/07/2020,WHP,CA,AWP,WE,Federal Contract Tower,0,0,3,0,3,0,0,134,0,134,0,0,137,0,137,262,0,262,399
03/08/2020,WHP,CA,AWP,WE,Federal Contract Tower,0,0,3,0,3,0,0,137,0,137,0,0,140,0,140,290,0,290,430
03/09/2020,WHP,CA,AWP,WE,Federal Contract Tower,0,0,0,0,0,0,0,81,0,81,0,0,81,0,81,108,0,108,189
03/10/2020,WHP,CA,AWP,WE,Federal Contract Tower,0,0,1,0,1,0,0,4,0,4,0,0,5,0,5,18,0,18,23
03/11/2020,WHP,CA,AWP,WE,Federal Contract Tower,0,0,6,0,6,0,0,53,0,53,0,0,59,0,59,76,0,76,135
03/12/2020,WHP,CA,AWP,WE,Federal Contract Tower,0,0,2,0,2,0,0,74,0,74,0,0,76,0,76,52,0,52,128
03/13/2020,WHP,CA,AWP,WE,Federal Contract Tower,0,0,1,0,1,0,0,17,0,17,0,0,18,0,18,0,0,0,18
03/14/2020,WHP,CA,AWP,WE,Federal Contract Tower,0,0,10,0,10,0,0,5,0,5,0,0,15,0,15,0,0,0,15
03/15/2020,WHP,CA,AWP,WE,Federal Contract Tower,0,0,0,0,0,0,0,61,0,61,0,0,61,0,61,128,0,128,189
03/16/2020,WHP,CA,AWP,WE,Federal Contract Tower,0,0,0,0,0,0,0,31,0,31,0,0,31,0,31,26,0,26,57
03/17/2020,WHP,CA,AWP,WE,Federal Contract Tower,0,0,0,0,0,0,0,19,0,19,0,0,19,0,19,86,0,86,105
03/18/2020,WHP,CA,AWP,WE,Federal Contract Tower,0,0,0,0,0,0,0,91,0,91,0,0,91,0,91,122,0,122,213
03/19/2020,WHP,CA,AWP,WE,Federal Contract Tower,0,0,0,0,0,0,0,42,0,42,0,0,42,0,42,48,0,48,90
03/20/2020,WHP,CA,AWP,WE,Federal Contract Tower,0,0,2,0,2,0,0,46,0,46,0,0,48,0,48,26,0,26,74
03/21/2020,WHP,CA,AWP,WE,Federal Contract Tower,0,0,0,0,0,0,0,95,0,95,0,0,95,0,95,140,0,140,235
03/22/2020,WHP,CA,AWP,WE,Federal Contract Tower,0,0,4,0,4,0,0,56,0,56,0,0,60,0,60,132,0,132,192
03/23/2020,WHP,CA,AWP,WE,Federal Contract Tower,0,0,0,0,0,0,0,21,0,21,0,0,21,0,21,0,0,0,21
03/24/2020,WHP,CA,AWP,WE,Federal Contract Tower,0,0,2,0,2,0,0,32,0,32,0,0,34,0,34,50,0,50,84
03/25/2020,WHP,CA,AWP,WE,Federal Contract Tower,0,0,1,0,1,0,0,36,0,36,0,0,37,0,37,18,0,18,55
03/26/2020,WHP,CA,AWP,WE,Federal Contract Tower,0,0,0,0,0,0,0,82,0,82,0,0,82,0,82,54,0,54,136
03/28/2020,WHP,CA,AWP,WE,Federal Contract Tower,0,0,1,0,1,0,0,113,0,113,0,0,114,0,114,72,0,72,186
03/29/2020,WHP,CA,AWP,WE,Federal Contract Tower,0,0,0,0,0,0,0,101,0,101,0,0,101,0,101,86,0,86,187
03/30/2020,WHP,CA,AWP,WE,Federal Contract Tower,0,0,0,0,0,0,0,130,0,130,0,0,130,0,130,48,0,48,178
03/31/2020,WHP,CA,AWP,WE,Federal Contract Tower,0,0,0,0,0,0,0,100,0,100,0,0,100,0,100,92,0,92,192
04/01/2020,WHP,CA,AWP,WE,Federal Contract Tower,0,0,0,0,0,0,0,109,0,109,0,0,109,0,109,116,0,116,225
04/02/2020,WHP,CA,AWP,WE,Federal Contract Tower,0,0,0,0,0,0,0,67,0,67,0,0,67,0,67,74,0,74,141
04/03/2020,WHP,CA,AWP,WE,Federal Contract Tower,0,0,0,0,0,0,0,112,0,112,0,0,112,0,112,128,0,128,240
04/04/2020,WHP,CA,AWP,WE,Federal Contract Tower,0,0,2,0,2,0,0,76,0,76,0,0,78,0,78,76,0,76,154
04/05/2020,WHP,CA,AWP,WE,Federal Contract Tower,0,0,2,0,2,0,0,0,0,0,0,0,2,0,2,28,0,28,30
04/06/2020,WHP,CA,AWP,WE,Federal Contract Tower,0,0,1,0,1,0,0,14,0,14,0,0,15,0,15,8,0,8,23
04/07/2020,WHP,CA,AWP,WE,Federal Contract Tower,0,0,2,0,2,0,0,18,0,18,0,0,20,0,20,34,0,34,54
04/08/2020,WHP,CA,AWP,WE,Federal Contract Tower,0,0,0,0,0,0,0,21,0,21,0,0,21,0,21,60,0,60,81
04/09/2020,WHP,CA,AWP,WE,Federal Contract Tower,0,0,2,0,2,0,0,16,0,16,0,0,18,0,18,0,0,0,18
04/10/2020,WHP,CA,AWP,WE,Federal Contract Tower,0,0,4,0,4,0,0,53,0,53,0,0,57,0,57,94,0,94,151
04/11/2020,WHP,CA,AWP,WE,Federal Contract Tower,0,0,0,0,0,0,0,120,0,120,0,0,120,0,120,140,0,140,260
04/12/2020,WHP,CA,AWP,WE,Federal Contract Tower,0,0,6,0,6,0,0,13,0,13,0,0,19,0,19,60,0,60,79
04/13/2020,WHP,CA,AWP,WE,Federal Contract Tower,0,0,1,0,1,0,0,54,0,54,0,0,55,0,55,84,0,84,139
04/14/2020,WHP,CA,AWP,WE,Federal Contract Tower,0,0,0,0,0,0,0,70,0,70,0,0,70,0,70,72,0,72,142
04/15/2020,WHP,CA,AWP,WE,Federal Contract Tower,0,0,1,0,1,0,0,132,0,132,0,0,133,0,133,150,0,150,283
04/16/2020,WHP,CA,AWP,WE,Federal Contract Tower,0,0,2,0,2,0,0,118,0,118,0,0,120,0,120,126,0,126,246
04/18/2020,WHP,CA,AWP,WE,Federal Contract Tower,0,0,0,0,0,0,0,40,0,40,0,0,40,0,40,64,0,64,104
04/19/2020,WHP,CA,AWP,WE,Federal Contract Tower,0,0,4,0,4,0,0,56,0,56,0,0,60,0,60,98,0,98,158
04/20/2020,WHP,CA,AWP,WE,Federal Contract Tower,0,0,4,0,4,0,0,71,0,71,0,0,75,0,75,130,0,130,205
04/21/2020,WHP,CA,AWP,WE,Federal Contract Tower,0,0,3,0,3,0,0,90,0,90,0,0,93,0,93,122,0,122,215
04/22/2020,WHP,CA,AWP,WE,Federal Contract Tower,0,0,0,0,0,0,0,122,0,122,0,0,122,0,122,102,0,102,224
04/23/2020,WHP,CA,AWP,WE,Federal Contract Tower,0,0,0,0,0,0,0,71,0,71,0,0,71,0,71,102,0,102,173
04/24/2020,WHP,CA,AWP,WE,Federal Contract Tower,0,0,1,0,1,0,0,73,0,73,0,0,74,0,74,130,0,130,204
04/25/2020,WHP,CA,AWP,WE,Federal Contract Tower,0,0,0,0,0,0,0,127,0,127,0,0,127,0,127,172,0,172,299
04/26/2020,WHP,CA,AWP,WE,Federal Contract Tower,0,0,0,0,0,0,0,99,0,99,0,0,99,0,99,114,0,114,213
04/27/2020,WHP,CA,AWP,WE,Federal Contract Tower,0,0,0,0,0,0,0,76,0,76,0,0,76,0,76,88,0,88,164
04/28/2020,WHP,CA,AWP,WE,Federal Contract Tower,0,0,0,0,0,0,0,107,0,107,0,0,107,0,107,204,0,204,311
04/29/2020,WHP,CA,AWP,WE,Federal Contract Tower,0,0,1,0,1,0,0,84,0,84,0,0,85,0,85,162,0,162,247
04/30/2020,WHP,CA,AWP,WE,Federal Contract Tower,0,0,0,0,0,0,0,108,0,108,0,0,108,0,108,168,0,168,276
05/01/2020,WHP,CA,AWP,WE,Federal Contract Tower,0,0,0,0,0,0,0,68,0,68,0,0,68,0,68,108,0,108,176
05/02/2020,WHP,CA,AWP,WE,Federal Contract Tower,0,0,0,0,0,0,0,68,0,68,0,0,68,0,68,118,0,118,186
05/03/2020,WHP,CA,AWP,WE,Federal Contract Tower,0,0,0,0,0,0,0,130,0,130,0,0,130,0,130,98,0,98,228
05/04/2020,WHP,CA,AWP,WE,Federal Contract Tower,0,0,0,0,0,0,0,107,0,107,0,0,107,0,107,137,0,137,244
05/05/2020,WHP,CA,AWP,WE,Federal Contract Tower,0,0,0,0,0,0,0,118,0,118,0,0,118,0,118,166,0,166,284
05/06/2020,WHP,CA,AWP,WE,Federal Contract Tower,0,0,0,0,0,0,0,124,0,124,0,0,124,0,124,172,0,172,296
05/07/2020,WHP,CA,AWP,WE,Federal Contract Tower,0,0,1,0,1,0,0,132,0,132,0,0,133,0,133,218,0,218,351
05/08/2020,WHP,CA,AWP,WE,Federal Contract Tower,0,0,0,0,0,0,0,149,0,149,0,0,149,0,149,0,214,214,363
05/09/2020,WHP,CA,AWP,WE,Federal Contract Tower,0,0,0,0,0,0,0,99,0,99,0,0,99,0,99,150,0,150,249
05/10/2020,WHP,CA,AWP,WE,Federal Contract Tower,0,0,3,0,3,0,0,79,0,79,0,0,82,0,82,68,0,68,150
05/11/2020,WHP,CA,AWP,WE,Federal Contract Tower,0,0,2,0,2,0,0,90,0,90,0,0,92,0,92,34,0,34,126
05/12/2020,WHP,CA,AWP,WE,Federal Contract Tower,0,0,0,0,0,0,0,81,0,81,0,0,81,0,81,150,0,150,231
05/14/2020,WHP,CA,AWP,WE,Federal Contract Tower,0,0,2,0,2,0,0,99,0,99,0,0,101,0,101,154,0,154,255
05/15/2020,WHP,CA,AWP,WE,Federal Contract Tower,0,0,0,0,0,0,0,131,0,131,0,0,131,0,131,178,0,178,309
05/16/2020,WHP,CA,AWP,WE,Federal Contract Tower,0,0,0,0,0,0,0,137,0,137,0,0,137,0,137,274,0,274,411
05/17/2020,WHP,CA,AWP,WE,Federal Contract Tower,0,0,1,0,1,0,0,135,0,135,0,0,136,0,136,304,0,304,440
05/19/2020,WHP,CA,AWP,WE,Federal Contract Tower,0,0,0,0,0,0,0,107,0,107,0,0,107,0,107,170,0,170,277
05/20/2020,WHP,CA,AWP,WE,Federal Contract Tower,0,0,2,0,2,0,0,127,0,127,0,0,129,0,129,112,0,112,241
05/21/2020,WHP,CA,AWP,WE,Federal Contract Tower,0,0,1,0,1,0,0,174,0,174,0,0,175,0,175,320,0,320,495
05/22/2020,WHP,CA,AWP,WE,Federal Contract Tower,0,0,0,0,0,0,0,144,0,144,0,0,144,0,144,298,0,298,442
05/23/2020,WHP,CA,AWP,WE,Federal Contract Tower,0,0,0,0,0,0,0,180,0,180,0,0,180,0,180,294,0,294,474
05/24/2020,WHP,CA,AWP,WE,Federal Contract Tower,0,0,7,0,7,0,0,184,0,184,0,0,191,0,191,196,0,196,387
05/25/2020,WHP,CA,AWP,WE,Federal Contract Tower,0,0,3,0,3,0,0,102,0,102,0,0,105,0,105,132,0,132,237
05/26/2020,WHP,CA,AWP,WE,Federal Contract Tower,0,0,0,0,0,0,0,118,0,118,0,0,118,0,118,134,0,134,252
05/27/2020,WHP,CA,AWP,WE,Federal Contract Tower,0,0,3,0,3,0,0,99,0,99,0,0,102,0,102,168,0,168,270
05/28/2020,WHP,CA,AWP,WE,Federal Contract Tower,0,0,1,0,1,0,0,111,0,111,0,0,112,0,112,172,2,174,286
05/29/2020,WHP,CA,AWP,WE,Federal Contract Tower,0,0,5,0,5,0,0,89,0,89,0,0,94,0,94,144,0,144,238
05/30/2020,WHP,CA,AWP,WE,Federal Contract Tower,0,0,0,0,0,0,0,145,0,145,0,0,145,0,145,252,0,252,397
05/31/2020,WHP,CA,AWP,WE,Federal Contract Tower,0,0,1,0,1,0,0,181,0,181,0,0,182,0,182,230,0,230,412
06/01/2020,WHP,CA,AWP,WE,Federal Contract Tower,0,0,1,0,1,0,0,71,0,71,0,0,72,0,72,92,0,92,164
06/02/2020,WHP,CA,AWP,WE,Federal Contract Tower,0,0,2,0,2,0,0,120,0,120,0,0,122,0,122,82,0,82,204
06/03/2020,WHP,CA,AWP,WE,Federal Contract Tower,0,0,0,0,0,0,0,131,0,131,0,0,131,0,131,178,0,178,309
06/04/2020,WHP,CA,AWP,WE,Federal Contract Tower,0,0,1,0,1,0,0,177,0,177,0,0,178,0,178,268,0,268,446
06/05/2020,WHP,CA,AWP,WE,Federal Contract Tower,0,0,2,0,2,0,0,87,0,87,0,0,89,0,89,108,0,108,197
06/06/2020,WHP,CA,AWP,WE,Federal Contract Tower,0,0,5,0,5,0,0,164,0,164,0,0,169,0,169,358,0,358,527
06/07/2020,WHP,CA,AWP,WE,Federal Contract Tower,0,0,3,0,3,0,0,71,0,71,0,0,74,0,74,72,0,72,146
06/08/2020,WHP,CA,AWP,WE,Federal Contract Tower,0,0,0,0,0,0,0,48,0,48,0,0,48,0,48,0,0,0,48
06/09/2020,WHP,CA,AWP,WE,Federal Contract Tower,0,0,0,0,0,0,0,117,0,117,0,0,117,0,117,264,0,264,381
06/10/2020,WHP,CA,AWP,WE,Federal Contract Tower,0,0,2,0,2,0,0,131,0,131,0,0,133,0,133,80,0,80,213
06/11/2020,WHP,CA,AWP,WE,Federal Contract Tower,0,0,0,0,0,0,0,162,0,162,0,0,162,0,162,334,0,334,496
06/12/2020,WHP,CA,AWP,WE,Federal Contract Tower,0,0,0,0,0,0,0,92,0,92,0,0,92,0,92,166,0,166,258
06/13/2020,WHP,CA,AWP,WE,Federal Contract Tower,0,0,0,0,0,0,0,131,0,131,0,0,131,0,131,174,0,174,305
06/14/2020,WHP,CA,AWP,WE,Federal Contract Tower,0,0,1,0,1,0,0,177,0,177,0,0,178,0,178,54,0,54,232
06/15/2020,WHP,CA,AWP,WE,Federal Contract Tower,0,0,0,0,0,0,0,103,0,103,0,0,103,0,103,252,0,252,355
06/16/2020,WHP,CA,AWP,WE,Federal Contract Tower,0,0,3,0,3,0,0,43,0,43,0,0,46,0,46,94,0,94,140
06/17/2020,WHP,CA,AWP,WE,Federal Contract Tower,0,0,0,0,0,0,0,119,0,119,0,0,119,0,119,292,0,292,411
06/18/2020,WHP,CA,AWP,WE,Federal Contract Tower,0,0,2,0,2,0,0,67,0,67,0,0,69,0,69,132,0,132,201
06/19/2020,WHP,CA,AWP,WE,Federal Contract Tower,0,0,4,0,4,0,0,103,0,103,0,0,107,0,107,188,0,188,295
06/20/2020,WHP,CA,AWP,WE,Federal Contract Tower,0,0,6,0,6,0,0,93,0,93,0,0,99,0,99,186,0,186,285
06/21/2020,WHP,CA,AWP,WE,Federal Contract Tower,0,0,7,0,7,0,0,67,0,67,0,0,74,0,74,144,0,144,218
06/22/2020,WHP,CA,AWP,WE,Federal Contract Tower,0,0,3,0,3,0,0,99,0,99,0,0,102,0,102,136,0,136,238
06/23/2020,WHP,CA,AWP,WE,Federal Contract Tower,0,0,3,0,3,0,0,101,0,101,0,0,104,0,104,152,0,152,256
06/24/2020,WHP,CA,AWP,WE,Federal Contract Tower,0,0,2,0,2,0,0,98,0,98,0,0,100,0,100,96,0,96,196
06/25/2020,WHP,CA,AWP,WE,Federal Contract Tower,0,0,1,0,1,0,0,121,0,121,0,0,122,0,122,288,0,288,410
06/26/2020,WHP,CA,AWP,WE,Federal Contract Tower,0,0,2,0,2,0,0,126,0,126,0,0,128,0,128,228,0,228,356
06/27/2020,WHP,CA,AWP,WE,Federal Contract Tower,0,0,0,0,0,0,0,157,0,157,0,0,157,0,157,278,0,278,435
06/28/2020,WHP,CA,AWP,WE,Federal Contract Tower,0,0,8,0,8,0,0,61,0,61,0,0,69,0,69,84,0,84,153
06/29/2020,WHP,CA,AWP,WE,Federal Contract Tower,0,0,0,0,0,0,0,78,0,78,0,0,78,0,78,136,0,136,214
06/30/2020,WHP,CA,AWP,WE,Federal Contract Tower,0,0,0,0,0,0,0,131,0,131,0,0,131,0,131,124,0,124,255
07/01/2020,WHP,CA,AWP,WE,Federal Contract Tower,0,0,2,0,2,0,0,126,0,126,0,0,128,0,128,192,0,192,320
07/02/2020,WHP,CA,AWP,WE,Federal Contract Tower,0,0,2,0,2,0,0,126,0,126,0,0,128,0,128,154,0,154,282
07/03/2020,WHP,CA,AWP,WE,Federal Contract Tower,0,0,2,0,2,0,0,190,0,190,0,0,192,0,192,212,0,212,404
07/04/2020,WHP,CA,AWP,WE,Federal Contract Tower,0,0,0,0,0,0,0,109,0,109,0,0,109,0,109,46,0,46,155
07/05/2020,WHP,CA,AWP,WE,Federal Contract Tower,0,0,0,0,0,0,0,120,0,120,0,0,120,0,120,116,0,116,236
07/06/2020,WHP,CA,AWP,WE,Federal Contract Tower,0,0,0,0,0,0,0,89,0,89,0,0,89,0,89,138,0,138,227
07/07/2020,WHP,CA,AWP,WE,Federal Contract Tower,0,0,1,0,1,0,0,132,0,132,0,0,133,0,133,222,0,222,355
07/08/2020,WHP,CA,AWP,WE,Federal Contract Tower,0,0,0,0,0,0,0,124,0,124,0,0,124,0,124,190,0,190,314
07/09/2020,WHP,CA,AWP,WE,Federal Contract Tower,0,0,0,0,0,0,0,126,0,126,0,0,126,0,126,278,0,278,404
07/10/2020,WHP,CA,AWP,WE,Federal Contract Tower,0,0,0,0,0,0,0,106,0,106,0,0,106,0,106,152,0,152,258
07/11/2020,WHP,CA,AWP,WE,Federal Contract Tower,0,0,0,0,0,0,0,106,0,106,0,0,106,0,106,154,0,154,260
07/12/2020,WHP,CA,AWP,WE,Federal Contract Tower,0,0,2,0,2,0,0,111,0,111,0,0,113,0,113,124,0,124,237
07/13/2020,WHP,CA,AWP,WE,Federal Contract Tower,0,0,0,0,0,0,0,76,0,76,0,0,76,0,76,68,0,68,144
07/14/2020,WHP,CA,AWP,WE,Federal Contract Tower,0,0,3,0,3,0,0,129,0,129,0,0,132,0,132,212,0,212,344
07/15/2020,WHP,CA,AWP,WE,Federal Contract Tower,0,0,2,0,2,0,0,130,0,130,0,0,132,0,132,244,0,244,376
07/16/2020,WHP,CA,AWP,WE,Federal Contract Tower,0,0,6,0,6,0,0,122,0,122,0,0,128,0,128,200,0,200,328
07/17/2020,WHP,CA,AWP,WE,Federal Contract Tower,0,0,0,0,0,0,0,102,0,102,0,0,102,0,102,240,0,240,342
07/18/2020,WHP,CA,AWP,WE,Federal Contract Tower,0,0,0,0,0,0,0,113,0,113,0,0,113,0,113,196,0,196,309
07/19/2020,WHP,CA,AWP,WE,Federal Contract Tower,0,0,3,0,3,0,0,129,0,129,0,0,132,0,132,164,0,164,296
07/20/2020,WHP,CA,AWP,WE,Federal Contract Tower,0,0,0,0,0,0,0,112,0,112,0,0,112,0,112,158,0,158,270
07/21/2020,WHP,CA,AWP,WE,Federal Contract Tower,0,0,4,0,4,0,0,142,0,142,0,0,146,0,146,198,0,198,344
07/22/2020,WHP,CA,AWP,WE,Federal Contract Tower,0,0,0,0,0,0,0,120,0,120,0,0,120,0,120,168,0,168,288
07/23/2020,WHP,CA,AWP,WE,Federal Contract Tower,0,0,1,0,1,0,0,81,0,81,0,0,82,0,82,310,0,310,392
07/24/2020,WHP,CA,AWP,WE,Federal Contract Tower,0,0,1,0,1,0,0,132,0,132,0,0,133,0,133,220,0,220,353
07/25/2020,WHP,CA,AWP,WE,Federal Contract Tower,0,0,0,0,0,0,0,182,0,182,0,0,182,0,182,272,0,272,454
07/26/2020,WHP,CA,AWP,WE,Federal Contract Tower,0,0,0,0,0,0,0,125,0,125,0,0,125,0,125,200,0,200,325
07/27/2020,WHP,CA,AWP,WE,Federal Contract Tower,0,0,2,0,2,0,0,115,0,115,0,0,117,0,117,166,0,166,283
07/28/2020,WHP,CA,AWP,WE,Federal Contract Tower,0,0,1,0,1,0,0,146,0,146,0,0,147,0,147,232,0,232,379
07/29/2020,WHP,CA,AWP,WE,Federal Contract Tower,0,0,0,0,0,0,0,130,0,130,0,0,130,0,130,214,0,214,344
07/30/2020,WHP,CA,AWP,WE,Federal Contract Tower,0,0,0,0,0,0,0,140,0,140,0,0,140,0,140,288,0,288,428
07/31/2020,WHP,CA,AWP,WE,Federal Contract Tower,0,0,0,0,0,0,0,118,0,118,0,0,118,0,118,144,0,144,262
08/01/2020,WHP,CA,AWP,WE,Federal Contract Tower,0,0,1,0,1,0,0,163,0,163,0,0,164,0,164,286,0,286,450
08/02/2020,WHP,CA,AWP,WE,Federal Contract Tower,0,0,0,0,0,0,0,129,0,129,0,0,129,0,129,162,0,162,291
08/03/2020,WHP,CA,AWP,WE,Federal Contract Tower,0,0,5,0,5,0,0,130,0,130,0,0,135,0,135,200,0,200,335
08/04/2020,WHP,CA,AWP,WE,Federal Contract Tower,0,0,1,0,1,0,0,123,0,123,0,0,124,0,124,194,0,194,318
08/05/2020,WHP,CA,AWP,WE,Federal Contract Tower,0,0,1,0,1,0,0,121,0,121,0,0,122,0,122,194,0,194,316
08/06/2020,WHP,CA,AWP,WE,Federal Contract Tower,0,0,4,0,4,0,0,85,0,85,0,0,89,0,89,216,0,216,305
08/07/2020,WHP,CA,AWP,WE,Federal Contract Tower,0,0,1,0,1,0,0,93,0,93,0,0,94,0,94,86,0,86,180
08/08/2020,WHP,CA,AWP,WE,Federal Contract Tower,0,0,2,0,2,0,0,148,0,148,0,0,150,0,150,334,0,334,484
08/09/2020,WHP,CA,AWP,WE,Federal Contract Tower,0,0,2,0,2,0,0,144,0,144,0,0,146,0,146,170,0,170,316
08/10/2020,WHP,CA,AWP,WE,Federal Contract Tower,0,0,4,0,4,0,0,119,0,119,0,0,123,0,123,176,0,176,299
08/11/2020,WHP,CA,AWP,WE,Federal Contract Tower,0,0,0,0,0,0,0,169,0,169,0,0,169,0,169,294,0,294,463
08/12/2020,WHP,CA,AWP,WE,Federal Contract Tower,0,0,0,0,0,0,0,141,0,141,0,0,141,0,141,158,0,158,299
08/13/2020,WHP,CA,AWP,WE,Federal Contract Tower,0,0,0,0,0,0,0,105,0,105,0,0,105,0,105,114,0,114,219
08/14/2020,WHP,CA,AWP,WE,Federal Contract Tower,0,0,0,0,0,0,0,105,0,105,0,0,105,0,105,150,0,150,255
08/15/2020,WHP,CA,AWP,WE,Federal Contract Tower,0,0,0,0,0,0,0,107,0,107,0,0,107,0,107,122,0,122,229
08/16/2020,WHP,CA,AWP,WE,Federal Contract Tower,0,0,0,0,0,0,0,128,0,128,0,0,128,0,128,128,0,128,256
08/17/2020,WHP,CA,AWP,WE,Federal Contract Tower,0,0,3,0,3,0,0,135,0,135,0,0,138,0,138,252,0,252,390
08/18/2020,WHP,CA,AWP,WE,Federal Contract Tower,0,0,1,0,1,0,0,94,0,94,0,0,95,0,95,122,0,122,217
08/19/2020,WHP,CA,AWP,WE,Federal Contract Tower,0,0,0,0,0,0,0,86,0,86,0,0,86,0,86,36,0,36,122
08/20/2020,WHP,CA,AWP,WE,Federal Contract Tower,0,0,2,0,2,0,0,102,0,102,0,0,104,0,104,224,0,224,328
08/21/2020,WHP,CA,AWP,WE,Federal Contract Tower,0,0,2,0,2,0,0,100,0,100,0,0,102,0,102,258,0,258,360
08/22/2020,WHP,CA,AWP,WE,Federal Contract Tower,0,0,1,0,1,0,0,147,0,147,0,0,148,0,148,182,0,182,330
08/23/2020,WHP,CA,AWP,WE,Federal Contract Tower,0,0,2,0,2,0,0,156,0,156,0,0,158,0,158,236,0,236,394
08/24/2020,WHP,CA,AWP,WE,Federal Contract Tower,0,0,1,0,1,0,0,145,0,145,0,0,146,0,146,258,0,258,404
08/25/2020,WHP,CA,AWP,WE,Federal Contract Tower,0,0,2,0,2,0,0,113,0,113,0,0,115,0,115,270,0,270,385
08/26/2020,WHP,CA,AWP,WE,Federal Contract Tower,0,0,0,0,0,0,0,112,0,112,0,0,112,0,112,218,0,218,330
08/27/2020,WHP,CA,AWP,WE,Federal Contract Tower,0,0,1,0,1,0,0,160,0,160,0,0,161,0,161,358,2,360,521
08/28/2020,WHP,CA,AWP,WE,Federal Contract Tower,0,0,0,0,0,0,22,149,0,171,0,22,149,0,171,306,0,306,477
08/29/2020,WHP,CA,AWP,WE,Federal Contract Tower,0,0,3,0,3,0,0,211,0,211,0,0,214,0,214,340,0,340,554
08/30/2020,WHP,CA,AWP,WE,Federal Contract Tower,0,0,5,0,5,0,0,135,0,135,0,0,140,0,140,228,0,228,368
08/31/2020,WHP,CA,AWP,WE,Federal Contract Tower,0,0,3,0,3,0,0,167,0,167,0,0,170,0,170,292,0,292,462
09/01/2020,WHP,CA,AWP,WE,Federal Contract Tower,0,0,2,0,2,0,0,128,0,128,0,0,130,0,130,264,0,264,394
09/02/2020,WHP,CA,AWP,WE,Federal Contract Tower,0,0,3,0,3,0,0,187,0,187,0,0,190,0,190,336,0,336,526
09/03/2020,WHP,CA,AWP,WE,Federal Contract Tower,0,0,0,0,0,0,0,163,0,163,0,0,163,0,163,383,0,383,546
09/04/2020,WHP,CA,AWP,WE,Federal Contract Tower,0,0,0,0,0,0,0,161,0,161,0,0,161,0,161,216,0,216,377
09/05/2020,WHP,CA,AWP,WE,Federal Contract Tower,0,0,1,0,1,0,0,50,0,50,0,0,51,0,51,62,0,62,113
09/06/2020,WHP,CA,AWP,WE,Federal Contract Tower,0,0,1,0,1,0,0,64,0,64,0,0,65,0,65,0,0,0,65
09/07/2020,WHP,CA,AWP,WE,Federal Contract Tower,0,0,2,0,2,0,0,70,0,70,0,0,72,0,72,118,0,118,190
09/08/2020,WHP,CA,AWP,WE,Federal Contract Tower,0,0,5,0,5,0,0,100,0,100,0,0,105,0,105,164,0,164,269
09/09/2020,WHP,CA,AWP,WE,Federal Contract Tower,0,0,1,0,1,0,0,93,0,93,0,0,94,0,94,160,0,160,254
09/10/2020,WHP,CA,AWP,WE,Federal Contract Tower,0,0,3,0,3,0,0,112,0,112,0,0,115,0,115,214,0,214,329
09/11/2020,WHP,CA,AWP,WE,Federal Contract Tower,0,0,1,0,1,0,0,71,0,71,0,0,72,0,72,116,0,116,188
09/12/2020,WHP,CA,AWP,WE,Federal Contract Tower,0,0,4,0,4,0,0,16,0,16,0,0,20,0,20,0,0,0,20
09/13/2020,WHP,CA,AWP,WE,Federal Contract Tower,0,0,1,0,1,0,0,82,0,82,0,0,83,0,83,108,0,108,191
09/14/2020,WHP,CA,AWP,WE,Federal Contract Tower,0,0,3,0,3,0,0,40,0,40,0,0,43,0,43,70,0,70,113
09/15/2020,WHP,CA,AWP,WE,Federal Contract Tower,0,0,3,0,3,0,0,66,0,66,0,0,69,0,69,150,0,150,219
09/16/2020,WHP,CA,AWP,WE,Federal Contract Tower,0,0,0,0,0,0,0,116,0,116,0,0,116,0,116,282,0,282,398
09/17/2020,WHP,CA,AWP,WE,Federal Contract Tower,0,0,3,0,3,0,0,77,0,77,0,0,80,0,80,124,0,124,204
09/18/2020,WHP,CA,AWP,WE,Federal Contract Tower,0,0,0,0,0,0,0,77,0,77,0,0,77,0,77,30,0,30,107
09/19/2020,WHP,CA,AWP,WE,Federal Contract Tower,0,0,1,0,1,0,0,129,0,129,0,0,130,0,130,240,0,240,370
09/20/2020,WHP,CA,AWP,WE,Federal Contract Tower,0,0,0,0,0,0,0,256,0,256,0,0,256,0,256,316,0,316,572
09/21/2020,WHP,CA,AWP,WE,Federal Contract Tower,0,0,1,0,1,0,0,80,0,80,0,0,81,0,81,126,0,126,207
09/22/2020,WHP,CA,AWP,WE,Federal Contract Tower,0,0,0,0,0,0,0,122,0,122,0,0,122,0,122,266,0,266,388
09/23/2020,WHP,CA,AWP,WE,Federal Contract Tower,0,0,0,0,0,0,0,138,0,138,0,0,138,0,138,282,0,282,420
09/24/2020,WHP,CA,AWP,WE,Federal Contract Tower,0,0,2,0,2,0,0,145,0,145,0,0,147,0,147,198,0,198,345
09/25/2020,WHP,CA,AWP,WE,Federal Contract Tower,2,0,0,0,2,0,0,111,0,111,2,0,111,0,113,206,0,206,319
09/26/2020,WHP,CA,AWP,WE,Federal Contract Tower,1,0,7,0,8,0,0,116,0,116,1,0,123,0,124,224,0,224,348
09/27/2020,WHP,CA,AWP,WE,Federal Contract Tower,0,0,4,0,4,0,0,137,0,137,0,0,141,0,141,200,0,200,341
09/28/2020,WHP,CA,AWP,WE,Federal Contract Tower,0,0,1,0,1,0,0,102,0,102,0,0,103,0,103,130,0,130,233
09/29/2020,WHP,CA,AWP,WE,Federal Contract Tower,0,0,0,0,0,0,0,139,0,139,0,0,139,0,139,232,0,232,371
09/30/2020,WHP,CA,AWP,WE,Federal Contract Tower,0,0,2,0,2,0,0,133,0,133,0,0,135,0,135,186,0,186,321
10/01/2020,WHP,CA,AWP,WE,Federal Contract Tower,0,0,0,0,0,0,0,96,0,96,0,0,96,0,96,100,0,100,196
10/02/2020,WHP,CA,AWP,WE,Federal Contract Tower,0,2,0,0,2,0,0,112,0,112,0,2,112,0,114,180,0,180,294
10/03/2020,WHP,CA,AWP,WE,Federal Contract Tower,0,0,0,0,0,0,0,151,0,151,0,0,151,0,151,346,0,346,497
10/04/2020,WHP,CA,AWP,WE,Federal Contract Tower,0,0,0,0,0,0,0,162,0,162,0,0,162,0,162,244,0,244,406
10/05/2020,WHP,CA,AWP,WE,Federal Contract Tower,0,0,0,0,0,0,0,177,0,177,0,0,177,0,177,224,0,224,401
10/06/2020,WHP,CA,AWP,WE,Federal Contract Tower,0,0,1,0,1,0,0,138,0,138,0,0,139,0,139,202,0,202,341
10/07/2020,WHP,CA,AWP,WE,Federal Contract Tower,0,0,1,0,1,0,0,164,0,164,0,0,165,0,165,232,0,232,397
10/08/2020,WHP,CA,AWP,WE,Federal Contract Tower,0,0,4,0,4,0,0,155,0,155,0,0,159,0,159,268,0,268,427
10/09/2020,WHP,CA,AWP,WE,Federal Contract Tower,0,0,8,0,8,0,0,75,0,75,0,0,83,0,83,218,0,218,301
10/10/2020,WHP,CA,AWP,WE,Federal Contract Tower,0,0,7,0,7,0,94,0,0,94,0,94,7,0,101,204,0,204,305
10/11/2020,WHP,CA,AWP,WE,Federal Contract Tower,0,0,2,0,2,0,0,207,0,207,0,0,209,0,209,340,0,340,549
10/12/2020,WHP,CA,AWP,WE,Federal Contract Tower,0,0,0,0,0,0,0,177,0,177,0,0,177,0,177,346,0,346,523
10/13/2020,WHP,CA,AWP,WE,Federal Contract Tower,0,0,0,0,0,0,0,165,0,165,0,0,165,0,165,208,0,208,373
10/14/2020,WHP,CA,AWP,WE,Federal Contract Tower,0,0,0,0,0,0,0,162,0,162,0,0,162,0,162,258,0,258,420
10/15/2020,WHP,CA,AWP,WE,Federal Contract Tower,0,0,2,0,2,0,0,148,0,148,0,0,150,0,150,316,0,316,466
10/16/2020,WHP,CA,AWP,WE,Federal Contract Tower,0,0,0,0,0,0,0,157,0,157,0,0,157,0,157,228,0,228,385
10/17/2020,WHP,CA,AWP,WE,Federal Contract Tower,0,0,0,0,0,0,0,177,0,177,0,0,177,0,177,278,0,278,455
10/18/2020,WHP,CA,AWP,WE,Federal Contract Tower,0,0,1,0,1,0,0,186,0,186,0,0,187,0,187,146,0,146,333
10/19/2020,WHP,CA,AWP,WE,Federal Contract Tower,0,0,1,0,1,0,0,108,0,108,0,0,109,0,109,130,0,130,239
10/20/2020,WHP,CA,AWP,WE,Federal Contract Tower,0,0,1,0,1,0,0,102,0,102,0,0,103,0,103,218,0,218,321
10/21/2020,WHP,CA,AWP,WE,Federal Contract Tower,0,0,2,1,3,0,0,0,71,71,0,0,2,72,74,72,0,72,146
10/22/2020,WHP,CA,AWP,WE,Federal Contract Tower,0,0,3,0,3,0,0,43,0,43,0,0,46,0,46,150,0,150,196
10/23/2020,WHP,CA,AWP,WE,Federal Contract Tower,0,0,4,0,4,0,0,110,0,110,0,0,114,0,114,240,0,240,354
10/24/2020,WHP,CA,AWP,WE,Federal Contract Tower,0,0,6,0,6,0,0,89,0,89,0,0,95,0,95,134,0,134,229
10/25/2020,WHP,CA,AWP,WE,Federal Contract Tower,0,0,6,0,6,0,0,126,0,126,0,0,132,0,132,284,0,284,416
10/26/2020,WHP,CA,AWP,WE,Federal Contract Tower,0,0,0,0,0,0,0,28,0,28,0,0,28,0,28,0,0,0,28
10/27/2020,WHP,CA,AWP,WE,Federal Contract Tower,0,0,0,0,0,0,0,107,0,107,0,0,107,0,107,46,0,46,153
10/28/2020,WHP,CA,AWP,WE,Federal Contract Tower,0,0,2,0,2,0,0,226,0,226,0,0,228,0,228,296,0,296,524
10/29/2020,WHP,CA,AWP,WE,Federal Contract Tower,0,0,0,0,0,0,0,154,0,154,0,0,154,0,154,242,0,242,396
10/30/2020,WHP,CA,AWP,WE,Federal Contract Tower,0,0,2,0,2,0,0,174,0,174,0,0,176,0,176,366,0,366,542
10/31/2020,WHP,CA,AWP,WE,Federal Contract Tower,0,0,1,0,1,0,0,249,0,249,0,0,250,0,250,320,0,320,570
11/01/2020,WHP,CA,AWP,WE,Federal Contract Tower,0,0,0,0,0,0,0,152,0,152,0,0,152,0,152,222,0,222,374
11/02/2020,WHP,CA,AWP,WE,Federal Contract Tower,0,0,0,0,0,0,0,140,0,140,0,0,140,0,140,192,0,192,332
11/03/2020,WHP,CA,AWP,WE,Federal Contract Tower,0,0,0,0,0,0,0,204,0,204,0,0,204,0,204,302,0,302,506
11/04/2020,WHP,CA,AWP,WE,Federal Contract Tower,0,0,3,0,3,0,0,186,0,186,0,0,189,0,189,296,0,296,485
11/05/2020,WHP,CA,AWP,WE,Federal Contract Tower,0,0,0,0,0,0,0,135,0,135,0,0,135,0,135,196,0,196,331
11/06/2020,WHP,CA,AWP,WE,Federal Contract Tower,0,0,2,0,2,0,0,151,0,151,0,0,153,0,153,266,0,266,419
11/07/2020,WHP,CA,AWP,WE,Federal Contract Tower,0,0,0,0,0,0,0,51,0,51,0,0,51,0,51,46,0,46,97
11/08/2020,WHP,CA,AWP,WE,Federal Contract Tower,0,0,0,0,0,0,0,25,0,25,0,0,25,0,25,44,0,44,69
11/09/2020,WHP,CA,AWP,WE,Federal Contract Tower,0,0,0,0,0,0,0,156,0,156,0,0,156,0,156,162,0,162,318
11/10/2020,WHP,CA,AWP,WE,Federal Contract Tower,0,0,2,0,2,0,0,161,0,161,0,0,163,0,163,272,0,272,435
11/11/2020,WHP,CA,AWP,WE,Federal Contract Tower,0,0,0,0,0,0,0,162,0,162,0,0,162,0,162,196,0,196,358
11/12/2020,WHP,CA,AWP,WE,Federal Contract Tower,0,0,0,0,0,0,0,98,0,98,0,0,98,0,98,36,0,36,134
11/13/2020,WHP,CA,AWP,WE,Federal Contract Tower,0,0,0,0,0,0,0,160,0,160,0,0,160,0,160,300,0,300,460
11/14/2020,WHP,CA,AWP,WE,Federal Contract Tower,0,0,0,0,0,0,0,138,0,138,0,0,138,0,138,162,0,162,300
11/15/2020,WHP,CA,AWP,WE,Federal Contract Tower,0,0,0,0,0,0,0,222,0,222,0,0,222,0,222,242,0,242,464
11/16/2020,WHP,CA,AWP,WE,Federal Contract Tower,0,0,0,0,0,0,0,109,0,109,0,0,109,0,109,128,0,128,237
11/17/2020,WHP,CA,AWP,WE,Federal Contract Tower,0,0,0,0,0,0,0,90,0,90,0,0,90,0,90,114,0,114,204
11/18/2020,WHP,CA,AWP,WE,Federal Contract Tower,0,0,0,0,0,0,0,127,0,127,0,0,127,0,127,102,0,102,229
11/19/2020,WHP,CA,AWP,WE,Federal Contract Tower,0,0,0,0,0,0,0,122,0,122,0,0,122,0,122,172,0,172,294
11/20/2020,WHP,CA,AWP,WE,Federal Contract Tower,0,0,0,0,0,0,0,115,0,115,0,0,115,0,115,148,0,148,263
11/21/2020,WHP,CA,AWP,WE,Federal Contract Tower,0,0,0,0,0,0,0,149,0,149,0,0,149,0,149,202,0,202,351
11/22/2020,WHP,CA,AWP,WE,Federal Contract Tower,0,0,0,0,0,0,0,155,0,155,0,0,155,0,155,190,0,190,345
11/23/2020,WHP,CA,AWP,WE,Federal Contract Tower,0,0,0,0,0,0,0,110,0,110,0,0,110,0,110,126,0,126,236
11/24/2020,WHP,CA,AWP,WE,Federal Contract Tower,0,0,1,0,1,0,0,141,0,141,0,0,142,0,142,184,0,184,326
11/25/2020,WHP,CA,AWP,WE,Federal Contract Tower,0,0,0,0,0,0,0,186,0,186,0,0,186,0,186,168,0,168,354
11/26/2020,WHP,CA,AWP,WE,Federal Contract Tower,0,0,0,0,0,0,0,30,0,30,0,0,30,0,30,20,0,20,50
11/27/2020,WHP,CA,AWP,WE,Federal Contract Tower,0,0,0,0,0,0,0,79,0,79,0,0,79,0,79,14,0,14,93
11/30/2020,WHP,CA,AWP,WE,Federal Contract Tower,0,0,0,0,0,0,0,116,0,116,0,0,116,0,116,180,0,180,296
12/01/2020,WHP,CA,AWP,WE,Federal Contract Tower,0,0,0,0,0,0,0,141,0,141,0,0,141,0,141,240,0,240,381
12/02/2020,WHP,CA,AWP,WE,Federal Contract Tower,0,0,0,0,0,0,0,139,0,139,0,0,139,0,139,150,0,150,289
12/03/2020,WHP,CA,AWP,WE,Federal Contract Tower,0,0,0,0,0,63,0,0,0,63,63,0,0,0,63,52,0,52,115
12/04/2020,WHP,CA,AWP,WE,Federal Contract Tower,0,0,0,0,0,0,0,126,0,126,0,0,126,0,126,104,0,104,230
12/05/2020,WHP,CA,AWP,WE,Federal Contract Tower,0,0,0,0,0,0,0,147,0,147,0,0,147,0,147,244,0,244,391
12/06/2020,WHP,CA,AWP,WE,Federal Contract Tower,0,0,4,0,4,0,0,184,0,184,0,0,188,0,188,256,0,256,444
12/08/2020,WHP,CA,AWP,WE,Federal Contract Tower,0,0,0,0,0,0,0,55,0,55,0,0,55,0,55,32,0,32,87
12/09/2020,WHP,CA,AWP,WE,Federal Contract Tower,0,0,0,0,0,0,0,0,0,0,0,0,0,0,0,178,0,178,178
12/10/2020,WHP,CA,AWP,WE,Federal Contract Tower,0,0,0,0,0,0,0,149,0,149,0,0,149,0,149,258,0,258,407
12/11/2020,WHP,CA,AWP,WE,Federal Contract Tower,0,0,0,0,0,0,0,89,0,89,0,0,89,0,89,128,0,128,217
12/12/2020,WHP,CA,AWP,WE,Federal Contract Tower,0,0,0,0,0,0,0,125,0,125,0,0,125,0,125,142,0,142,267
12/13/2020,WHP,CA,AWP,WE,Federal Contract Tower,0,0,1,0,1,0,0,209,0,209,0,0,210,0,210,316,0,316,526
12/14/2020,WHP,CA,AWP,WE,Federal Contract Tower,0,0,0,0,0,0,0,24,0,24,0,0,24,0,24,18,0,18,42
12/15/2020,WHP,CA,AWP,WE,Federal Contract Tower,0,0,0,0,0,0,0,50,0,50,0,0,50,0,50,0,0,0,50
12/16/2020,WHP,CA,AWP,WE,Federal Contract Tower,0,0,0,0,0,0,0,131,0,131,0,0,131,0,131,60,0,60,191
12/17/2020,WHP,CA,AWP,WE,Federal Contract Tower,0,0,0,0,0,0,0,135,0,135,0,0,135,0,135,214,0,214,349
12/18/2020,WHP,CA,AWP,WE,Federal Contract Tower,0,0,0,0,0,0,0,100,0,100,0,0,100,0,100,80,0,80,180
12/19/2020,WHP,CA,AWP,WE,Federal Contract Tower,0,0,3,0,3,0,0,181,0,181,0,0,184,0,184,294,0,294,478
12/20/2020,WHP,CA,AWP,WE,Federal Contract Tower,0,0,1,0,1,0,0,167,0,167,0,0,168,0,168,230,0,230,398
12/21/2020,WHP,CA,AWP,WE,Federal Contract Tower,0,0,0,0,0,0,149,0,0,149,0,149,0,0,149,98,0,98,247
12/22/2020,WHP,CA,AWP,WE,Federal Contract Tower,0,0,0,0,0,0,0,149,0,149,0,0,149,0,149,184,0,184,333
12/23/2020,WHP,CA,AWP,WE,Federal Contract Tower,0,0,1,0,1,0,0,90,0,90,0,0,91,0,91,132,0,132,223
12/24/2020,WHP,CA,AWP,WE,Federal Contract Tower,0,0,0,0,0,0,0,45,0,45,0,0,45,0,45,40,0,40,85
12/25/2020,WHP,CA,AWP,WE,Federal Contract Tower,0,0,0,0,0,0,0,71,0,71,0,0,71,0,71,46,0,46,117
12/26/2020,WHP,CA,AWP,WE,Federal Contract Tower,0,0,0,0,0,0,0,131,0,131,0,0,131,0,131,182,0,182,313
12/27/2020,WHP,CA,AWP,WE,Federal Contract Tower,0,0,0,0,0,0,0,121,0,121,0,0,121,0,121,195,0,195,316
12/28/2020,WHP,CA,AWP,WE,Federal Contract Tower,0,0,0,0,0,0,0,13,0,13,0,0,13,0,13,14,0,14,27
12/29/2020,WHP,CA,AWP,WE,Federal Contract Tower,0,0,0,0,0,0,0,115,0,115,0,0,115,0,115,142,0,142,257
12/30/2020,WHP,CA,AWP,WE,Federal Contract Tower,0,0,3,0,3,0,0,18,0,18,0,0,21,0,21,234,0,234,255
12/31/2020,WHP,CA,AWP,WE,Federal Contract Tower,0,0,2,0,2,0,0,60,0,60,0,0,62,0,62,2,0,2,64
01/01/2021,WHP,CA,AWP,WE,Federal Contract Tower,0,0,0,0,0,0,0,66,0,66,0,0,66,0,66,20,0,20,86
01/02/2021,WHP,CA,AWP,WE,Federal Contract Tower,0,0,5,0,5,0,0,178,0,178,0,0,183,0,183,352,0,352,535
01/03/2021,WHP,CA,AWP,WE,Federal Contract Tower,0,0,2,0,2,0,0,137,0,137,0,0,139,0,139,160,0,160,299
01/04/2021,WHP,CA,AWP,WE,Federal Contract Tower,0,0,3,0,3,0,0,117,0,117,0,0,120,0,120,240,0,240,360
01/05/2021,WHP,CA,AWP,WE,Federal Contract Tower,0,0,0,0,0,0,0,146,0,146,0,0,146,0,146,216,0,216,362
01/06/2021,WHP,CA,AWP,WE,Federal Contract Tower,0,0,0,0,0,0,0,154,0,154,0,0,154,0,154,170,0,170,324
01/07/2021,WHP,CA,AWP,WE,Federal Contract Tower,0,0,0,0,0,0,0,155,0,155,0,0,155,0,155,196,0,196,351
01/08/2021,WHP,CA,AWP,WE,Federal Contract Tower,0,0,3,0,3,0,0,85,0,85,0,0,88,0,88,88,0,88,176
01/09/2021,WHP,CA,AWP,WE,Federal Contract Tower,0,0,0,0,0,0,0,20,0,20,0,0,20,0,20,2,0,2,22
01/10/2021,WHP,CA,AWP,WE,Federal Contract Tower,0,0,0,0,0,0,0,162,0,162,0,0,162,0,162,300,0,300,462
01/11/2021,WHP,CA,AWP,WE,Federal Contract Tower,0,0,1,0,1,0,0,107,0,107,0,0,108,0,108,224,0,224,332
01/12/2021,WHP,CA,AWP,WE,Federal Contract Tower,0,0,0,0,0,0,0,142,0,142,0,0,142,0,142,182,0,182,324
01/13/2021,WHP,CA,AWP,WE,Federal Contract Tower,0,0,0,0,0,0,0,114,0,114,0,0,114,0,114,44,0,44,158
01/14/2021,WHP,CA,AWP,WE,Federal Contract Tower,0,0,0,0,0,0,0,128,0,128,0,0,128,0,128,128,0,128,256
01/15/2021,WHP,CA,AWP,WE,Federal Contract Tower,0,0,0,0,0,0,0,65,0,65,0,0,65,0,65,18,0,18,83
01/17/2021,WHP,CA,AWP,WE,Federal Contract Tower,0,0,1,0,1,0,0,163,0,163,0,0,164,0,164,280,0,280,444
01/18/2021,WHP,CA,AWP,WE,Federal Contract Tower,0,0,0,0,0,0,0,84,0,84,0,0,84,0,84,32,0,32,116
01/19/2021,WHP,CA,AWP,WE,Federal Contract Tower,0,0,0,0,0,0,0,29,0,29,0,0,29,0,29,0,0,0,29
01/20/2021,WHP,CA,AWP,WE,Federal Contract Tower,0,0,0,0,0,0,0,35,0,35,0,0,35,0,35,0,0,0,35
01/21/2021,WHP,CA,AWP,WE,Federal Contract Tower,0,0,5,0,5,0,0,117,0,117,0,0,122,0,122,260,0,260,382
01/22/2021,WHP,CA,AWP,WE,Federal Contract Tower,0,0,12,0,12,0,0,54,0,54,0,0,66,0,66,60,0,60,126
01/23/2021,WHP,CA,AWP,WE,Federal Contract Tower,0,0,8,0,8,0,0,48,0,48,0,0,56,0,56,72,0,72,128
01/24/2021,WHP,CA,AWP,WE,Federal Contract Tower,0,0,0,0,0,0,0,214,0,214,0,0,214,0,214,348,0,348,562
01/25/2021,WHP,CA,AWP,WE,Federal Contract Tower,0,0,1,0,1,0,0,20,0,20,0,0,21,0,21,0,0,0,21
01/26/2021,WHP,CA,AWP,WE,Federal Contract Tower,0,0,1,0,1,0,0,135,0,135,0,0,136,0,136,128,0,128,264
01/27/2021,WHP,CA,AWP,WE,Federal Contract Tower,0,0,0,0,0,0,0,39,0,39,0,0,39,0,39,0,0,0,39
01/28/2021,WHP,CA,AWP,WE,Federal Contract Tower,0,0,4,0,4,0,0,50,0,50,0,0,54,0,54,4,0,4,58
01/29/2021,WHP,CA,AWP,WE,Federal Contract Tower,0,0,0,0,0,0,0,30,0,30,0,0,30,0,30,0,0,0,30
01/30/2021,WHP,CA,AWP,WE,Federal Contract Tower,0,0,0,0,0,0,0,232,0,232,0,0,232,0,232,182,0,182,414
01/31/2021,WHP,CA,AWP,WE,Federal Contract Tower,0,0,1,0,1,0,0,141,0,141,0,0,142,0,142,192,0,192,334
02/01/2021,WHP,CA,AWP,WE,Federal Contract Tower,0,0,3,0,3,0,0,83,0,83,0,0,86,0,86,174,0,174,260
02/02/2021,WHP,CA,AWP,WE,Federal Contract Tower,0,0,1,0,1,0,0,196,0,196,0,0,197,0,197,284,0,284,481
02/03/2021,WHP,CA,AWP,WE,Federal Contract Tower,0,0,1,0,1,0,0,166,0,166,0,0,167,0,167,242,0,242,409
02/04/2021,WHP,CA,AWP,WE,Federal Contract Tower,0,0,13,0,13,0,0,135,0,135,0,0,148,0,148,116,0,116,264
02/05/2021,WHP,CA,AWP,WE,Federal Contract Tower,0,0,4,0,4,0,0,172,0,172,0,0,176,0,176,256,0,256,432
02/06/2021,WHP,CA,AWP,WE,Federal Contract Tower,0,0,4,0,4,0,0,394,0,394,0,0,398,0,398,368,0,368,766
02/07/2021,WHP,CA,AWP,WE,Federal Contract Tower,0,0,0,0,0,0,0,217,0,217,0,0,217,0,217,242,0,242,459
02/08/2021,WHP,CA,AWP,WE,Federal Contract Tower,0,0,2,0,2,0,0,110,0,110,0,0,112,0,112,186,0,186,298
02/09/2021,WHP,CA,AWP,WE,Federal Contract Tower,0,0,2,0,2,0,0,61,0,61,0,0,63,0,63,120,0,120,183
02/10/2021,WHP,CA,AWP,WE,Federal Contract Tower,0,0,0,0,0,0,0,153,0,153,0,0,153,0,153,340,0,340,493
02/11/2021,WHP,CA,AWP,WE,Federal Contract Tower,0,0,2,0,2,0,0,120,0,120,0,0,122,0,122,188,0,188,310
02/12/2021,WHP,CA,AWP,WE,Federal Contract Tower,0,0,6,0,6,0,0,41,0,41,0,0,47,0,47,0,0,0,47
02/13/2021,WHP,CA,AWP,WE,Federal Contract Tower,0,0,4,0,4,0,0,44,0,44,0,0,48,0,48,82,0,82,130
02/14/2021,WHP,CA,AWP,WE,Federal Contract Tower,0,0,1,0,1,0,0,22,0,22,0,0,23,0,23,6,0,6,29
02/15/2021,WHP,CA,AWP,WE,Federal Contract Tower,0,0,4,0,4,0,0,135,0,135,0,0,139,0,139,222,0,222,361
02/16/2021,WHP,CA,AWP,WE,Federal Contract Tower,0,0,1,0,1,0,0,36,0,36,0,0,37,0,37,26,0,26,63
02/17/2021,WHP,CA,AWP,WE,Federal Contract Tower,0,0,1,0,1,0,0,79,0,79,0,0,80,0,80,30,0,30,110
02/18/2021,WHP,CA,AWP,WE,Federal Contract Tower,0,0,0,0,0,0,0,105,0,105,0,0,105,0,105,114,0,114,219
02/19/2021,WHP,CA,AWP,WE,Federal Contract Tower,0,0,4,0,4,0,0,168,0,168,0,0,172,0,172,282,0,282,454
02/20/2021,WHP,CA,AWP,WE,Federal Contract Tower,0,0,0,0,0,0,0,29,0,29,0,0,29,0,29,0,0,0,29
02/21/2021,WHP,CA,AWP,WE,Federal Contract Tower,0,0,0,0,0,0,0,128,0,128,0,0,128,0,128,156,0,156,284
02/22/2021,WHP,CA,AWP,WE,Federal Contract Tower,0,0,0,0,0,0,0,131,0,131,0,0,131,0,131,162,0,162,293
02/23/2021,WHP,CA,AWP,WE,Federal Contract Tower,0,0,0,0,0,0,0,186,0,186,0,0,186,0,186,288,0,288,474
02/24/2021,WHP,CA,AWP,WE,Federal Contract Tower,0,0,0,0,0,0,0,207,0,207,0,0,207,0,207,342,0,342,549
02/25/2021,WHP,CA,AWP,WE,Federal Contract Tower,0,0,0,0,0,0,0,67,0,67,0,0,67,0,67,18,0,18,85
02/26/2021,WHP,CA,AWP,WE,Federal Contract Tower,0,0,0,0,0,0,0,149,0,149,0,0,149,0,149,278,0,278,427
02/27/2021,WHP,CA,AWP,WE,Federal Contract Tower,0,0,0,0,0,0,0,23,0,23,0,0,23,0,23,0,0,0,23
02/28/2021,WHP,CA,AWP,WE,Federal Contract Tower,0,0,0,0,0,0,0,25,0,25,0,0,25,0,25,40,0,40,65
03/01/2021,WHP,CA,AWP,WE,Federal Contract Tower,0,0,0,0,0,0,0,152,0,152,0,0,152,0,152,208,0,208,360
03/02/2021,WHP,CA,AWP,WE,Federal Contract Tower,0,0,0,0,0,0,0,147,0,147,0,0,147,0,147,298,0,298,445
03/03/2021,WHP,CA,AWP,WE,Federal Contract Tower,0,0,2,0,2,0,0,49,0,49,0,0,51,0,51,18,0,18,69
03/04/2021,WHP,CA,AWP,WE,Federal Contract Tower,0,0,0,0,0,0,0,148,0,148,0,0,148,0,148,266,0,266,414
03/05/2021,WHP,CA,AWP,WE,Federal Contract Tower,0,0,0,0,0,0,0,154,0,154,0,0,154,0,154,284,0,284,438
03/06/2021,WHP,CA,AWP,WE,Federal Contract Tower,0,0,0,0,0,0,0,241,0,241,0,0,241,0,241,386,0,386,627
03/07/2021,WHP,CA,AWP,WE,Federal Contract Tower,0,0,7,0,7,0,0,189,0,189,0,0,196,0,196,386,0,386,582
03/08/2021,WHP,CA,AWP,WE,Federal Contract Tower,0,0,7,0,7,0,0,105,0,105,0,0,112,0,112,182,0,182,294
03/09/2021,WHP,CA,AWP,WE,Federal Contract Tower,0,0,0,0,0,0,0,117,0,117,0,0,117,0,117,260,0,260,377
03/10/2021,WHP,CA,AWP,WE,Federal Contract Tower,0,0,0,0,0,0,0,32,0,32,0,0,32,0,32,24,0,24,56
03/11/2021,WHP,CA,AWP,WE,Federal Contract Tower,0,0,2,0,2,0,0,70,0,70,0,0,72,0,72,64,0,64,136
03/12/2021,WHP,CA,AWP,WE,Federal Contract Tower,0,0,2,0,2,0,0,60,0,60,0,0,62,0,62,106,0,106,168
03/13/2021,WHP,CA,AWP,WE,Federal Contract Tower,0,0,4,0,4,0,0,215,0,215,0,0,219,0,219,324,0,324,543
03/14/2021,WHP,CA,AWP,WE,Federal Contract Tower,0,0,0,0,0,0,0,177,0,177,0,0,177,0,177,316,0,316,493
03/15/2021,WHP,CA,AWP,WE,Federal Contract Tower,0,0,0,0,0,0,0,19,0,19,0,0,19,0,19,18,0,18,37
03/16/2021,WHP,CA,AWP,WE,Federal Contract Tower,0,0,3,0,3,0,0,151,0,151,0,0,154,0,154,294,0,294,448
03/17/2021,WHP,CA,AWP,WE,Federal Contract Tower,0,0,0,0,0,0,0,161,0,161,0,0,161,0,161,324,0,324,485
03/18/2021,WHP,CA,AWP,WE,Federal Contract Tower,0,0,4,0,4,0,0,120,0,120,0,0,124,0,124,150,0,150,274
03/19/2021,WHP,CA,AWP,WE,Federal Contract Tower,0,0,0,0,0,0,0,141,0,141,0,0,141,0,141,260,0,260,401
03/20/2021,WHP,CA,AWP,WE,Federal Contract Tower,0,0,7,0,7,0,0,97,0,97,0,0,104,0,104,178,0,178,282
03/21/2021,WHP,CA,AWP,WE,Federal Contract Tower,0,0,0,0,0,0,0,63,0,63,0,0,63,0,63,80,0,80,143
03/22/2021,WHP,CA,AWP,WE,Federal Contract Tower,0,0,0,0,0,0,0,92,0,92,0,0,92,0,92,88,0,88,180
03/23/2021,WHP,CA,AWP,WE,Federal Contract Tower,0,0,1,0,1,0,0,39,0,39,0,0,40,0,40,22,0,22,62
03/24/2021,WHP,CA,AWP,WE,Federal Contract Tower,0,0,0,0,0,0,0,71,0,71,0,0,71,0,71,36,0,36,107
03/25/2021,WHP,CA,AWP,WE,Federal Contract Tower,0,0,1,0,1,0,0,81,0,81,0,0,82,0,82,122,0,122,204
03/26/2021,WHP,CA,AWP,WE,Federal Contract Tower,0,0,0,0,0,0,0,59,0,59,0,0,59,0,59,112,0,112,171
03/27/2021,WHP,CA,AWP,WE,Federal Contract Tower,0,0,7,0,7,0,0,207,0,207,0,0,214,0,214,240,0,240,454
03/28/2021,WHP,CA,AWP,WE,Federal Contract Tower,0,0,0,0,0,0,0,216,0,216,0,0,216,0,216,262,0,262,478
03/29/2021,WHP,CA,AWP,WE,Federal Contract Tower,0,0,0,0,0,0,0,175,0,175,0,0,175,0,175,198,0,198,373
03/30/2021,WHP,CA,AWP,WE,Federal Contract Tower,0,0,3,0,3,0,0,127,0,127,0,0,130,0,130,254,0,254,384
03/31/2021,WHP,CA,AWP,WE,Federal Contract Tower,0,0,0,0,0,0,0,95,0,95,0,0,95,0,95,154,0,154,249
04/01/2021,WHP,CA,AWP,WE,Federal Contract Tower,0,0,0,0,0,0,0,155,0,155,0,0,155,0,155,298,0,298,453
04/02/2021,WHP,CA,AWP,WE,Federal Contract Tower,0,0,6,0,6,0,0,171,0,171,0,0,177,0,177,296,0,296,473
04/03/2021,WHP,CA,AWP,WE,Federal Contract Tower,0,0,4,0,4,0,0,211,0,211,0,0,215,0,215,402,0,402,617
04/04/2021,WHP,CA,AWP,WE,Federal Contract Tower,0,0,1,0,1,0,0,200,0,200,0,0,201,0,201,278,0,278,479
04/05/2021,WHP,CA,AWP,WE,Federal Contract Tower,0,0,0,0,0,0,0,156,0,156,0,0,156,0,156,190,0,190,346
04/06/2021,WHP,CA,AWP,WE,Federal Contract Tower,0,0,2,0,2,0,0,161,0,161,0,0,163,0,163,308,0,308,471
04/07/2021,WHP,CA,AWP,WE,Federal Contract Tower,0,0,2,0,2,0,0,155,0,155,0,0,157,0,157,390,0,390,547
04/08/2021,WHP,CA,AWP,WE,Federal Contract Tower,0,0,0,0,0,0,0,104,0,104,0,0,104,0,104,144,0,144,248
04/09/2021,WHP,CA,AWP,WE,Federal Contract Tower,0,0,0,0,0,0,0,171,0,171,0,0,171,0,171,238,0,238,409
04/10/2021,WHP,CA,AWP,WE,Federal Contract Tower,0,0,0,0,0,0,0,174,0,174,0,0,174,0,174,258,0,258,432
04/11/2021,WHP,CA,AWP,WE,Federal Contract Tower,0,0,0,0,0,0,0,172,0,172,0,0,172,0,172,228,0,228,400
04/12/2021,WHP,CA,AWP,WE,Federal Contract Tower,0,0,17,0,17,0,0,75,0,75,0,0,92,0,92,92,0,92,184
04/13/2021,WHP,CA,AWP,WE,Federal Contract Tower,0,0,1,0,1,0,0,63,0,63,0,0,64,0,64,10,0,10,74
04/14/2021,WHP,CA,AWP,WE,Federal Contract Tower,0,0,7,0,7,0,0,77,0,77,0,0,84,0,84,122,0,122,206
04/15/2021,WHP,CA,AWP,WE,Federal Contract Tower,0,0,0,0,0,0,0,99,0,99,0,0,99,0,99,96,0,96,195
04/16/2021,WHP,CA,AWP,WE,Federal Contract Tower,0,0,0,0,0,0,0,125,0,125,0,0,125,0,125,244,0,244,369
04/17/2021,WHP,CA,AWP,WE,Federal Contract Tower,0,0,1,0,1,0,0,195,0,195,0,0,196,0,196,302,0,302,498
04/18/2021,WHP,CA,AWP,WE,Federal Contract Tower,0,0,1,0,1,0,0,10,0,10,0,0,11,0,11,20,0,20,31
04/19/2021,WHP,CA,AWP,WE,Federal Contract Tower,0,0,6,0,6,0,0,101,0,101,0,0,107,0,107,218,0,218,325
04/20/2021,WHP,CA,AWP,WE,Federal Contract Tower,0,0,0,0,0,0,0,132,0,132,0,0,132,0,132,322,0,322,454
04/21/2021,WHP,CA,AWP,WE,Federal Contract Tower,0,0,6,0,6,0,0,85,0,85,0,0,91,0,91,122,0,122,213
04/22/2021,WHP,CA,AWP,WE,Federal Contract Tower,0,0,7,0,7,0,0,34,0,34,0,0,41,0,41,115,0,115,156
04/23/2021,WHP,CA,AWP,WE,Federal Contract Tower,0,0,7,0,7,0,0,115,0,115,0,0,122,0,122,230,0,230,352
04/24/2021,WHP,CA,AWP,WE,Federal Contract Tower,0,0,7,0,7,0,0,190,0,190,0,0,197,0,197,462,0,462,659
04/25/2021,WHP,CA,AWP,WE,Federal Contract Tower,0,0,5,0,5,0,0,128,0,128,0,0,133,0,133,224,0,224,357
04/26/2021,WHP,CA,AWP,WE,Federal Contract Tower,0,0,0,0,0,0,0,78,0,78,0,0,78,0,78,196,0,196,274
04/27/2021,WHP,CA,AWP,WE,Federal Contract Tower,0,0,2,0,2,0,0,106,0,106,0,0,108,0,108,298,0,298,406
04/28/2021,WHP,CA,AWP,WE,Federal Contract Tower,0,0,5,0,5,0,0,45,0,45,0,0,50,0,50,42,0,42,92
04/29/2021,WHP,CA,AWP,WE,Federal Contract Tower,0,0,1,0,1,0,0,145,0,145,0,0,146,0,146,354,0,354,500
04/30/2021,WHP,CA,AWP,WE,Federal Contract Tower,0,0,1,0,1,0,0,142,0,142,0,0,143,0,143,222,0,222,365
05/01/2021,WHP,CA,AWP,WE,Federal Contract Tower,0,0,1,0,1,0,0,154,0,154,0,0,155,0,155,350,0,350,505
05/02/2021,WHP,CA,AWP,WE,Federal Contract Tower,0,0,0,0,0,0,0,140,0,140,0,0,140,0,140,326,0,326,466
05/03/2021,WHP,CA,AWP,WE,Federal Contract Tower,0,0,0,0,0,0,0,130,0,130,0,0,130,0,130,228,0,228,358
05/04/2021,WHP,CA,AWP,WE,Federal Contract Tower,0,0,4,0,4,0,0,90,0,90,0,0,94,0,94,262,0,262,356
05/05/2021,WHP,CA,AWP,WE,Federal Contract Tower,0,0,0,0,0,0,0,122,0,122,0,0,122,0,122,204,0,204,326
05/06/2021,WHP,CA,AWP,WE,Federal Contract Tower,0,0,5,0,5,0,0,123,0,123,0,0,128,0,128,330,0,330,458
05/07/2021,WHP,CA,AWP,WE,Federal Contract Tower,0,0,6,0,6,0,0,130,0,130,0,0,136,0,136,218,0,218,354
05/08/2021,WHP,CA,AWP,WE,Federal Contract Tower,0,0,0,0,0,0,0,172,0,172,0,0,172,0,172,394,0,394,566
05/09/2021,WHP,CA,AWP,WE,Federal Contract Tower,0,0,5,0,5,0,0,136,0,136,0,0,141,0,141,220,0,220,361
05/10/2021,WHP,CA,AWP,WE,Federal Contract Tower,0,0,25,0,25,0,0,66,0,66,0,0,91,0,91,258,0,258,349
05/11/2021,WHP,CA,AWP,WE,Federal Contract Tower,0,0,5,0,5,0,0,99,0,99,0,0,104,0,104,352,0,352,456
05/12/2021,WHP,CA,AWP,WE,Federal Contract Tower,0,0,1,0,1,0,0,104,0,104,0,0,105,0,105,186,0,186,291
05/13/2021,WHP,CA,AWP,WE,Federal Contract Tower,0,0,2,0,2,0,0,149,0,149,0,0,151,0,151,304,0,304,455
05/14/2021,WHP,CA,AWP,WE,Federal Contract Tower,0,0,4,0,4,0,0,104,0,104,0,0,108,0,108,266,0,266,374
05/15/2021,WHP,CA,AWP,WE,Federal Contract Tower,0,0,2,0,2,0,0,92,0,92,0,0,94,0,94,182,0,182,276
05/16/2021,WHP,CA,AWP,WE,Federal Contract Tower,0,0,28,0,28,0,0,70,0,70,0,0,98,0,98,150,0,150,248
05/17/2021,WHP,CA,AWP,WE,Federal Contract Tower,0,0,12,0,12,0,0,116,0,116,0,0,128,0,128,216,0,216,344
05/18/2021,WHP,CA,AWP,WE,Federal Contract Tower,0,0,3,0,3,0,0,91,0,91,0,0,94,0,94,250,0,250,344
05/19/2021,WHP,CA,AWP,WE,Federal Contract Tower,0,0,6,0,6,0,0,125,0,125,0,0,131,0,131,242,0,242,373
05/20/2021,WHP,CA,AWP,WE,Federal Contract Tower,0,0,4,0,4,0,0,113,0,113,0,0,117,0,117,130,0,130,247
05/21/2021,WHP,CA,AWP,WE,Federal Contract Tower,0,0,2,0,2,0,0,67,0,67,0,0,69,0,69,68,0,68,137
05/22/2021,WHP,CA,AWP,WE,Federal Contract Tower,0,0,4,0,4,0,0,182,0,182,0,0,186,0,186,214,0,214,400
05/24/2021,WHP,CA,AWP,WE,Federal Contract Tower,0,0,1,0,1,0,0,166,0,166,0,0,167,0,167,178,0,178,345
05/25/2021,WHP,CA,AWP,WE,Federal Contract Tower,0,0,0,0,0,0,0,108,0,108,0,0,108,0,108,102,0,102,210
05/26/2021,WHP,CA,AWP,WE,Federal Contract Tower,0,0,0,0,0,0,0,157,0,157,0,0,157,0,157,354,0,354,511
05/27/2021,WHP,CA,AWP,WE,Federal Contract Tower,0,0,0,0,0,0,0,116,0,116,0,0,116,0,116,164,0,164,280
05/28/2021,WHP,CA,AWP,WE,Federal Contract Tower,0,0,3,0,3,0,0,132,0,132,0,0,135,0,135,106,0,106,241
05/29/2021,WHP,CA,AWP,WE,Federal Contract Tower,0,0,16,0,16,0,0,100,0,100,0,0,116,0,116,142,0,142,258
05/30/2021,WHP,CA,AWP,WE,Federal Contract Tower,0,0,1,0,1,0,0,138,0,138,0,0,139,0,139,204,0,204,343
05/31/2021,WHP,CA,AWP,WE,Federal Contract Tower,0,0,13,0,13,0,0,174,0,174,0,0,187,0,187,216,0,216,403
06/01/2021,WHP,CA,AWP,WE,Federal Contract Tower,0,0,0,0,0,0,0,160,0,160,0,0,160,0,160,250,0,250,410
06/02/2021,WHP,CA,AWP,WE,Federal Contract Tower,0,0,4,0,4,0,0,147,0,147,0,0,151,0,151,310,0,310,461
06/03/2021,WHP,CA,AWP,WE,Federal Contract Tower,0,0,0,0,0,0,0,177,0,177,0,0,177,0,177,290,0,290,467
06/04/2021,WHP,CA,AWP,WE,Federal Contract Tower,0,0,0,0,0,0,0,199,0,199,0,0,199,0,199,256,0,256,455
06/05/2021,WHP,CA,AWP,WE,Federal Contract Tower,0,0,8,0,8,0,0,243,0,243,0,0,251,0,251,316,0,316,567
06/06/2021,WHP,CA,AWP,WE,Federal Contract Tower,0,0,5,0,5,0,0,152,0,152,0,0,157,0,157,302,0,302,459
06/07/2021,WHP,CA,AWP,WE,Federal Contract Tower,0,0,14,0,14,0,0,52,0,52,0,0,66,0,66,120,0,120,186
06/08/2021,WHP,CA,AWP,WE,Federal Contract Tower,0,0,6,0,6,0,0,114,0,114,0,0,120,0,120,250,0,250,370
06/09/2021,WHP,CA,AWP,WE,Federal Contract Tower,0,0,0,0,0,0,0,110,0,110,0,0,110,0,110,144,0,144,254
06/10/2021,WHP,CA,AWP,WE,Federal Contract Tower,0,0,0,0,0,0,0,97,0,97,0,0,97,0,97,116,0,116,213
06/11/2021,WHP,CA,AWP,WE,Federal Contract Tower,0,0,0,0,0,0,0,203,0,203,0,0,203,0,203,274,0,274,477
06/12/2021,WHP,CA,AWP,WE,Federal Contract Tower,0,0,1,0,1,0,0,202,0,202,0,0,203,0,203,354,0,354,557
06/13/2021,WHP,CA,AWP,WE,Federal Contract Tower,0,0,2,0,2,0,0,192,0,192,0,0,194,0,194,238,0,238,432
06/14/2021,WHP,CA,AWP,WE,Federal Contract Tower,0,0,0,0,0,0,0,206,0,206,0,0,206,0,206,326,0,326,532
06/15/2021,WHP,CA,AWP,WE,Federal Contract Tower,0,0,3,0,3,0,0,107,0,107,0,0,110,0,110,132,0,132,242
06/16/2021,WHP,CA,AWP,WE,Federal Contract Tower,0,0,0,0,0,0,0,114,0,114,0,0,114,0,114,160,0,160,274
06/17/2021,WHP,CA,AWP,WE,Federal Contract Tower,0,0,0,0,0,0,0,115,0,115,0,0,115,0,115,162,0,162,277
06/18/2021,WHP,CA,AWP,WE,Federal Contract Tower,0,0,1,0,1,0,0,206,0,206,0,0,207,0,207,368,0,368,575
06/19/2021,WHP,CA,AWP,WE,Federal Contract Tower,0,0,2,0,2,0,0,165,0,165,0,0,167,0,167,256,0,256,423
06/20/2021,WHP,CA,AWP,WE,Federal Contract Tower,0,0,5,0,5,0,0,162,0,162,0,0,167,0,167,248,0,248,415
06/21/2021,WHP,CA,AWP,WE,Federal Contract Tower,0,0,4,0,4,0,0,132,0,132,0,0,136,0,136,190,0,190,326
06/22/2021,WHP,CA,AWP,WE,Federal Contract Tower,0,0,0,0,0,0,0,115,0,115,0,0,115,0,115,188,0,188,303
06/23/2021,WHP,CA,AWP,WE,Federal Contract Tower,0,0,0,0,0,0,0,113,0,113,0,0,113,0,113,186,0,186,299
06/24/2021,WHP,CA,AWP,WE,Federal Contract Tower,0,0,0,0,0,0,0,138,0,138,0,0,138,0,138,266,0,266,404
06/25/2021,WHP,CA,AWP,WE,Federal Contract Tower,0,0,0,0,0,0,0,167,0,167,0,0,167,0,167,86,0,86,253
06/26/2021,WHP,CA,AWP,WE,Federal Contract Tower,0,0,0,0,0,0,0,259,0,259,0,0,259,0,259,140,0,140,399
06/27/2021,WHP,CA,AWP,WE,Federal Contract Tower,0,0,0,0,0,0,0,188,0,188,0,0,188,0,188,208,0,208,396
06/28/2021,WHP,CA,AWP,WE,Federal Contract Tower,0,0,0,0,0,0,0,96,0,96,0,0,96,0,96,150,0,150,246
06/29/2021,WHP,CA,AWP,WE,Federal Contract Tower,0,0,2,0,2,0,0,77,0,77,0,0,79,0,79,90,0,90,169
06/30/2021,WHP,CA,AWP,WE,Federal Contract Tower,0,0,4,0,4,0,0,108,0,108,0,0,112,0,112,162,0,162,274
07/01/2021,WHP,CA,AWP,WE,Federal Contract Tower,0,0,3,0,3,0,0,132,0,132,0,0,135,0,135,152,0,152,287
07/02/2021,WHP,CA,AWP,WE,Federal Contract Tower,0,0,2,0,2,0,0,133,0,133,0,0,135,0,135,88,0,88,223
07/03/2021,WHP,CA,AWP,WE,Federal Contract Tower,0,0,1,0,1,0,0,150,0,150,0,0,151,0,151,264,0,264,415
07/04/2021,WHP,CA,AWP,WE,Federal Contract Tower,0,0,0,0,0,0,0,114,0,114,0,0,114,0,114,160,0,160,274
07/05/2021,WHP,CA,AWP,WE,Federal Contract Tower,0,0,2,0,2,0,0,120,0,120,0,0,122,0,122,164,0,164,286
07/06/2021,WHP,CA,AWP,WE,Federal Contract Tower,0,0,0,0,0,0,0,111,0,111,0,0,111,0,111,160,0,160,271
07/07/2021,WHP,CA,AWP,WE,Federal Contract Tower,0,0,0,0,0,0,0,117,0,117,0,0,117,0,117,194,0,194,311
07/08/2021,WHP,CA,AWP,WE,Federal Contract Tower,0,0,1,0,1,0,0,128,0,128,0,0,129,0,129,176,0,176,305
07/09/2021,WHP,CA,AWP,WE,Federal Contract Tower,0,0,0,0,0,0,0,147,0,147,0,0,147,0,147,172,0,172,319
07/10/2021,WHP,CA,AWP,WE,Federal Contract Tower,0,0,0,0,0,0,0,195,0,195,0,0,195,0,195,214,0,214,409
07/11/2021,WHP,CA,AWP,WE,Federal Contract Tower,0,0,0,0,0,0,0,166,0,166,0,0,166,0,166,156,0,156,322
07/12/2021,WHP,CA,AWP,WE,Federal Contract Tower,0,0,1,0,1,0,0,136,0,136,0,0,137,0,137,192,0,192,329
07/13/2021,WHP,CA,AWP,WE,Federal Contract Tower,0,0,0,0,0,0,0,114,0,114,0,0,114,0,114,228,0,228,342
07/14/2021,WHP,CA,AWP,WE,Federal Contract Tower,0,0,3,0,3,0,0,14,0,14,0,0,17,0,17,298,0,298,315
07/15/2021,WHP,CA,AWP,WE,Federal Contract Tower,0,0,1,0,1,0,0,119,0,119,0,0,120,0,120,94,0,94,214
07/16/2021,WHP,CA,AWP,WE,Federal Contract Tower,0,0,2,0,2,0,0,187,0,187,0,0,189,0,189,240,0,240,429
07/17/2021,WHP,CA,AWP,WE,Federal Contract Tower,0,0,0,0,0,0,0,177,0,177,0,0,177,0,177,182,0,182,359
07/18/2021,WHP,CA,AWP,WE,Federal Contract Tower,0,0,0,0,0,0,0,202,0,202,0,0,202,0,202,212,0,212,414
07/19/2021,WHP,CA,AWP,WE,Federal Contract Tower,0,0,4,0,4,0,0,178,0,178,0,0,182,0,182,250,0,250,432
07/20/2021,WHP,CA,AWP,WE,Federal Contract Tower,0,0,1,0,1,0,0,95,0,95,0,0,96,0,96,134,0,134,230
07/21/2021,WHP,CA,AWP,WE,Federal Contract Tower,0,0,0,0,0,0,0,85,0,85,0,0,85,0,85,150,0,150,235
07/22/2021,WHP,CA,AWP,WE,Federal Contract Tower,0,0,0,0,0,0,0,111,0,111,0,0,111,0,111,168,0,168,279
07/23/2021,WHP,CA,AWP,WE,Federal Contract Tower,0,0,0,0,0,0,0,204,0,204,0,0,204,0,204,202,0,202,406
07/24/2021,WHP,CA,AWP,WE,Federal Contract Tower,0,0,0,0,0,0,0,236,0,236,0,0,236,0,236,272,0,272,508
07/25/2021,WHP,CA,AWP,WE,Federal Contract Tower,0,0,0,0,0,0,0,168,0,168,0,0,168,0,168,106,0,106,274
07/26/2021,WHP,CA,AWP,WE,Federal Contract Tower,0,0,0,0,0,0,0,98,0,98,0,0,98,0,98,164,0,164,262
07/27/2021,WHP,CA,AWP,WE,Federal Contract Tower,0,0,4,0,4,0,0,85,0,85,0,0,89,0,89,84,0,84,173
07/28/2021,WHP,CA,AWP,WE,Federal Contract Tower,0,0,0,0,0,0,0,194,0,194,0,0,194,0,194,278,0,278,472
07/29/2021,WHP,CA,AWP,WE,Federal Contract Tower,0,0,1,0,1,0,0,120,0,120,0,0,121,0,121,202,0,202,323
07/30/2021,WHP,CA,AWP,WE,Federal Contract Tower,0,0,0,0,0,0,0,169,0,169,0,0,169,0,169,236,0,236,405
07/31/2021,WHP,CA,AWP,WE,Federal Contract Tower,0,0,1,0,1,0,0,178,0,178,0,0,179,0,179,244,0,244,423
08/01/2021,WHP,CA,AWP,WE,Federal Contract Tower,0,0,0,0,0,0,0,177,0,177,0,0,177,0,177,164,0,164,341
08/02/2021,WHP,CA,AWP,WE,Federal Contract Tower,0,0,0,0,0,0,0,145,0,145,0,0,145,0,145,140,0,140,285
08/03/2021,WHP,CA,AWP,WE,Federal Contract Tower,0,0,0,0,0,0,0,131,0,131,0,0,131,0,131,130,0,130,261
08/04/2021,WHP,CA,AWP,WE,Federal Contract Tower,0,0,0,0,0,0,0,100,0,100,0,0,100,0,100,166,0,166,266
08/05/2021,WHP,CA,AWP,WE,Federal Contract Tower,0,0,0,0,0,0,0,136,0,136,0,0,136,0,136,132,0,132,268
08/06/2021,WHP,CA,AWP,WE,Federal Contract Tower,0,0,0,0,0,0,0,197,0,197,0,0,197,0,197,206,0,206,403
08/07/2021,WHP,CA,AWP,WE,Federal Contract Tower,0,0,2,0,2,0,0,157,0,157,0,0,159,0,159,246,0,246,405
08/08/2021,WHP,CA,AWP,WE,Federal Contract Tower,0,0,1,0,1,0,0,176,0,176,0,0,177,0,177,170,0,170,347
08/09/2021,WHP,CA,AWP,WE,Federal Contract Tower,0,0,0,0,0,0,0,190,0,190,0,0,190,0,190,194,0,194,384
08/10/2021,WHP,CA,AWP,WE,Federal Contract Tower,0,0,1,0,1,0,0,75,0,75,0,0,76,0,76,116,0,116,192
08/11/2021,WHP,CA,AWP,WE,Federal Contract Tower,0,0,2,0,2,0,0,121,0,121,0,0,123,0,123,208,0,208,331
08/12/2021,WHP,CA,AWP,WE,Federal Contract Tower,0,0,0,0,0,0,0,121,0,121,0,0,121,0,121,122,0,122,243
08/13/2021,WHP,CA,AWP,WE,Federal Contract Tower,0,0,0,0,0,0,0,169,0,169,0,0,169,0,169,244,0,244,413
08/14/2021,WHP,CA,AWP,WE,Federal Contract Tower,0,0,0,0,0,0,0,170,0,170,0,0,170,0,170,236,0,236,406
08/15/2021,WHP,CA,AWP,WE,Federal Contract Tower,0,0,1,0,1,0,0,192,0,192,0,0,193,0,193,180,0,180,373
08/16/2021,WHP,CA,AWP,WE,Federal Contract Tower,0,0,0,0,0,0,0,148,0,148,0,0,148,0,148,202,0,202,350
08/17/2021,WHP,CA,AWP,WE,Federal Contract Tower,0,0,0,0,0,0,0,103,0,103,0,0,103,0,103,176,0,176,279
08/18/2021,WHP,CA,AWP,WE,Federal Contract Tower,0,0,2,0,2,0,0,24,0,24,0,0,26,0,26,44,0,44,70
08/19/2021,WHP,CA,AWP,WE,Federal Contract Tower,0,0,2,0,2,0,0,154,0,154,0,0,156,0,156,296,0,296,452
08/20/2021,WHP,CA,AWP,WE,Federal Contract Tower,0,0,1,0,1,0,0,146,0,146,0,0,147,0,147,180,0,180,327
08/21/2021,WHP,CA,AWP,WE,Federal Contract Tower,0,0,0,0,0,0,0,102,0,102,0,0,102,0,102,184,0,184,286
08/22/2021,WHP,CA,AWP,WE,Federal Contract Tower,0,0,4,0,4,0,0,208,0,208,0,0,212,0,212,280,0,280,492
08/23/2021,WHP,CA,AWP,WE,Federal Contract Tower,0,0,2,0,2,0,0,0,0,0,0,0,2,0,2,358,0,358,360
08/24/2021,WHP,CA,AWP,WE,Federal Contract Tower,0,0,1,0,1,0,0,146,0,146,0,0,147,0,147,324,0,324,471
08/25/2021,WHP,CA,AWP,WE,Federal Contract Tower,0,0,0,0,0,0,0,156,0,156,0,0,156,0,156,286,0,286,442
08/26/2021,WHP,CA,AWP,WE,Federal Contract Tower,0,0,0,0,0,0,0,171,0,171,0,0,171,0,171,146,0,146,317
08/27/2021,WHP,CA,AWP,WE,Federal Contract Tower,0,0,2,0,2,0,0,113,0,113,0,0,115,0,115,84,0,84,199
08/28/2021,WHP,CA,AWP,WE,Federal Contract Tower,0,0,0,0,0,0,0,217,0,217,0,0,217,0,217,172,0,172,389
08/29/2021,WHP,CA,AWP,WE,Federal Contract Tower,0,0,0,0,0,0,0,174,0,174,0,0,174,0,174,198,0,198,372
08/30/2021,WHP,CA,AWP,WE,Federal Contract Tower,0,0,2,0,2,0,0,132,0,132,0,0,134,0,134,202,0,202,336
08/31/2021,WHP,CA,AWP,WE,Federal Contract Tower,0,0,1,0,1,0,0,61,0,61,0,0,62,0,62,198,0,198,260
09/01/2021,WHP,CA,AWP,WE,Federal Contract Tower,0,0,12,0,12,0,0,98,0,98,0,0,110,0,110,132,0,132,242
09/02/2021,WHP,CA,AWP,WE,Federal Contract Tower,0,0,4,0,4,0,0,104,0,104,0,0,108,0,108,208,0,208,316
09/03/2021,WHP,CA,AWP,WE,Federal Contract Tower,0,0,0,0,0,0,0,153,0,153,0,0,153,0,153,154,0,154,307
09/04/2021,WHP,CA,AWP,WE,Federal Contract Tower,0,0,0,0,0,0,0,173,0,173,0,0,173,0,173,220,0,220,393
09/05/2021,WHP,CA,AWP,WE,Federal Contract Tower,0,0,0,0,0,0,0,188,0,188,0,0,188,0,188,234,0,234,422
09/06/2021,WHP,CA,AWP,WE,Federal Contract Tower,0,0,4,0,4,0,0,122,0,122,0,0,126,0,126,90,0,90,216
09/07/2021,WHP,CA,AWP,WE,Federal Contract Tower,0,0,0,0,0,0,0,111,0,111,0,0,111,0,111,328,0,328,439
09/08/2021,WHP,CA,AWP,WE,Federal Contract Tower,0,0,0,0,0,0,0,142,0,142,0,0,142,0,142,188,0,188,330
09/09/2021,WHP,CA,AWP,WE,Federal Contract Tower,0,0,0,0,0,0,0,131,0,131,0,0,131,0,131,230,0,230,361
09/10/2021,WHP,CA,AWP,WE,Federal Contract Tower,0,0,0,0,0,0,0,167,0,167,0,0,167,0,167,318,0,318,485
09/11/2021,WHP,CA,AWP,WE,Federal Contract Tower,0,0,0,0,0,0,0,156,0,156,0,0,156,0,156,240,0,240,396
09/12/2021,WHP,CA,AWP,WE,Federal Contract Tower,0,0,2,0,2,0,0,222,0,222,0,0,224,0,224,284,0,284,508
09/13/2021,WHP,CA,AWP,WE,Federal Contract Tower,0,0,1,0,1,0,0,100,0,100,0,0,101,0,101,162,0,162,263
09/14/2021,WHP,CA,AWP,WE,Federal Contract Tower,0,0,0,0,0,0,0,79,0,79,0,0,79,0,79,136,0,136,215
09/15/2021,WHP,CA,AWP,WE,Federal Contract Tower,0,0,3,0,3,0,0,93,0,93,0,0,96,0,96,158,0,158,254
09/16/2021,WHP,CA,AWP,WE,Federal Contract Tower,0,0,1,0,1,0,0,105,0,105,0,0,106,0,106,204,0,204,310
09/17/2021,WHP,CA,AWP,WE,Federal Contract Tower,0,0,0,0,0,0,0,132,0,132,0,0,132,0,132,176,0,176,308
09/18/2021,WHP,CA,AWP,WE,Federal Contract Tower,0,0,1,0,1,0,0,224,0,224,0,0,225,0,225,296,0,296,521
09/19/2021,WHP,CA,AWP,WE,Federal Contract Tower,0,0,11,0,11,0,0,158,0,158,0,0,169,0,169,202,0,202,371
09/20/2021,WHP,CA,AWP,WE,Federal Contract Tower,0,0,3,0,3,0,0,176,0,176,0,0,179,0,179,232,0,232,411
09/21/2021,WHP,CA,AWP,WE,Federal Contract Tower,0,0,0,0,0,0,0,96,0,96,0,0,96,0,96,152,0,152,248
09/22/2021,WHP,CA,AWP,WE,Federal Contract Tower,0,0,2,0,2,0,0,110,0,110,0,0,112,0,112,130,0,130,242
09/24/2021,WHP,CA,AWP,WE,Federal Contract Tower,0,0,2,0,2,0,0,137,0,137,0,0,139,0,139,200,0,200,339
09/25/2021,WHP,CA,AWP,WE,Federal Contract Tower,0,0,0,0,0,0,0,262,0,262,0,0,262,0,262,242,0,242,504
09/26/2021,WHP,CA,AWP,WE,Federal Contract Tower,0,0,5,0,5,0,0,157,0,157,0,0,162,0,162,258,0,258,420
09/27/2021,WHP,CA,AWP,WE,Federal Contract Tower,0,0,4,0,4,0,0,45,0,45,0,0,49,0,49,76,0,76,125
09/28/2021,WHP,CA,AWP,WE,Federal Contract Tower,0,0,19,0,19,0,0,57,0,57,0,0,76,0,76,130,0,130,206
09/29/2021,WHP,CA,AWP,WE,Federal Contract Tower,0,0,5,0,5,0,0,115,0,115,0,0,120,0,120,166,0,166,286
09/30/2021,WHP,CA,AWP,WE,Federal Contract Tower,0,0,2,0,2,0,0,144,0,144,0,0,146,0,146,150,0,150,296
10/01/2021,WHP,CA,AWP,WE,Federal Contract Tower,0,0,0,0,0,0,0,123,0,123,0,0,123,0,123,136,0,136,259
10/02/2021,WHP,CA,AWP,WE,Federal Contract Tower,0,0,0,0,0,0,0,196,0,196,0,0,196,0,196,302,0,302,498
10/03/2021,WHP,CA,AWP,WE,Federal Contract Tower,0,0,0,0,0,0,0,272,0,272,0,0,272,0,272,246,0,246,518
10/04/2021,WHP,CA,AWP,WE,Federal Contract Tower,0,0,2,0,2,0,0,164,0,164,0,0,166,0,166,196,0,196,362
10/05/2021,WHP,CA,AWP,WE,Federal Contract Tower,0,0,3,0,3,0,0,110,0,110,0,0,113,0,113,146,0,146,259
10/06/2021,WHP,CA,AWP,WE,Federal Contract Tower,0,0,0,0,0,0,0,103,0,103,0,0,103,0,103,126,0,126,229
10/07/2021,WHP,CA,AWP,WE,Federal Contract Tower,0,0,3,0,3,0,0,49,0,49,0,0,52,0,52,108,0,108,160
10/08/2021,WHP,CA,AWP,WE,Federal Contract Tower,0,0,2,0,2,0,0,113,0,113,0,0,115,0,115,208,0,208,323
10/09/2021,WHP,CA,AWP,WE,Federal Contract Tower,0,0,3,0,3,0,0,162,0,162,0,0,165,0,165,156,0,156,321
10/10/2021,WHP,CA,AWP,WE,Federal Contract Tower,0,0,0,0,0,0,0,240,0,240,0,0,240,0,240,280,0,280,520
10/11/2021,WHP,CA,AWP,WE,Federal Contract Tower,0,0,0,0,0,0,0,78,0,78,0,0,78,0,78,128,0,128,206
10/12/2021,WHP,CA,AWP,WE,Federal Contract Tower,0,0,0,0,0,0,0,53,0,53,0,0,53,0,53,48,0,48,101
10/13/2021,WHP,CA,AWP,WE,Federal Contract Tower,0,0,1,0,1,0,0,112,0,112,0,0,113,0,113,124,0,124,237
10/14/2021,WHP,CA,AWP,WE,Federal Contract Tower,0,0,5,0,5,0,0,153,0,153,0,0,158,0,158,178,0,178,336
10/15/2021,WHP,CA,AWP,WE,Federal Contract Tower,0,0,0,0,0,0,0,145,0,145,0,0,145,0,145,140,0,140,285
10/16/2021,WHP,CA,AWP,WE,Federal Contract Tower,0,0,0,0,0,0,0,150,0,150,0,0,150,0,150,180,0,180,330
10/17/2021,WHP,CA,AWP,WE,Federal Contract Tower,0,0,3,0,3,0,0,226,0,226,0,0,229,0,229,314,0,314,543
10/18/2021,WHP,CA,AWP,WE,Federal Contract Tower,0,0,2,0,2,0,0,76,0,76,0,0,78,0,78,94,0,94,172
10/19/2021,WHP,CA,AWP,WE,Federal Contract Tower,0,0,0,0,0,0,0,106,0,106,0,0,106,0,106,110,0,110,216
10/20/2021,WHP,CA,AWP,WE,Federal Contract Tower,0,0,3,0,3,0,0,146,0,146,0,0,149,0,149,234,0,234,383
10/21/2021,WHP,CA,AWP,WE,Federal Contract Tower,0,0,8,0,8,0,0,200,0,200,0,0,208,0,208,266,0,266,474
10/22/2021,WHP,CA,AWP,WE,Federal Contract Tower,0,0,0,0,0,0,0,196,0,196,0,0,196,0,196,318,0,318,514
10/23/2021,WHP,CA,AWP,WE,Federal Contract Tower,0,0,8,0,8,0,0,107,0,107,0,0,115,0,115,354,0,354,469
10/24/2021,WHP,CA,AWP,WE,Federal Contract Tower,0,0,5,0,5,0,0,118,0,118,0,0,123,0,123,324,0,324,447
10/25/2021,WHP,CA,AWP,WE,Federal Contract Tower,0,0,2,0,2,0,0,4,0,4,0,0,6,0,6,0,0,0,6
10/26/2021,WHP,CA,AWP,WE,Federal Contract Tower,0,0,1,0,1,0,0,57,0,57,0,0,58,0,58,102,0,102,160
10/27/2021,WHP,CA,AWP,WE,Federal Contract Tower,0,0,3,0,3,0,0,121,0,121,0,0,124,0,124,202,0,202,326
10/28/2021,WHP,CA,AWP,WE,Federal Contract Tower,0,0,0,0,0,0,0,178,0,178,0,0,178,0,178,308,0,308,486
10/29/2021,WHP,CA,AWP,WE,Federal Contract Tower,0,0,1,0,1,0,0,179,0,179,0,0,180,0,180,248,0,248,428
10/30/2021,WHP,CA,AWP,WE,Federal Contract Tower,0,0,5,0,5,0,0,186,0,186,0,0,191,0,191,370,0,370,561
10/31/2021,WHP,CA,AWP,WE,Federal Contract Tower,0,0,10,0,10,0,0,80,0,80,0,0,90,0,90,178,0,178,268
11/01/2021,WHP,CA,AWP,WE,Federal Contract Tower,0,0,11,0,11,0,0,118,0,118,0,0,129,0,129,220,0,220,349
11/02/2021,WHP,CA,AWP,WE,Federal Contract Tower,0,0,1,0,1,0,0,79,0,79,0,0,80,0,80,172,0,172,252
11/03/2021,WHP,CA,AWP,WE,Federal Contract Tower,0,0,1,0,1,0,0,131,0,131,0,0,132,0,132,234,0,234,366
11/04/2021,WHP,CA,AWP,WE,Federal Contract Tower,0,0,3,0,3,0,0,131,0,131,0,0,134,0,134,250,0,250,384
11/05/2021,WHP,CA,AWP,WE,Federal Contract Tower,0,0,0,0,0,0,0,195,0,195,0,0,195,0,195,356,0,356,551
11/06/2021,WHP,CA,AWP,WE,Federal Contract Tower,0,0,3,0,3,0,0,143,0,143,0,0,146,0,146,288,0,288,434
11/07/2021,WHP,CA,AWP,WE,Federal Contract Tower,0,0,10,0,10,0,0,148,0,148,0,0,158,0,158,268,0,268,426
11/08/2021,WHP,CA,AWP,WE,Federal Contract Tower,0,0,0,0,0,0,0,134,0,134,0,0,134,0,134,286,0,286,420
11/09/2021,WHP,CA,AWP,WE,Federal Contract Tower,0,0,0,0,0,0,0,101,0,101,0,0,101,0,101,220,0,220,321
11/10/2021,WHP,CA,AWP,WE,Federal Contract Tower,0,0,2,0,2,0,0,146,0,146,0,0,148,0,148,178,0,178,326
11/11/2021,WHP,CA,AWP,WE,Federal Contract Tower,0,0,0,0,0,0,0,127,0,127,0,0,127,0,127,206,0,206,333
11/12/2021,WHP,CA,AWP,WE,Federal Contract Tower,0,0,0,0,0,0,0,106,0,106,0,0,106,0,106,70,0,70,176
11/13/2021,WHP,CA,AWP,WE,Federal Contract Tower,0,0,1,0,1,0,0,183,0,183,0,0,184,0,184,278,0,278,462
11/14/2021,WHP,CA,AWP,WE,Federal Contract Tower,0,0,8,0,8,0,0,1960,0,1960,0,0,1968,0,1968,294,0,294,2262
11/15/2021,WHP,CA,AWP,WE,Federal Contract Tower,0,0,4,0,4,0,0,168,0,168,0,0,172,0,172,278,0,278,450
11/16/2021,WHP,CA,AWP,WE,Federal Contract Tower,0,0,3,0,3,0,0,112,0,112,0,0,115,0,115,158,0,158,273
11/17/2021,WHP,CA,AWP,WE,Federal Contract Tower,0,0,3,0,3,0,0,132,0,132,0,0,135,0,135,232,0,232,367
11/18/2021,WHP,CA,AWP,WE,Federal Contract Tower,0,0,0,0,0,0,0,141,0,141,0,0,141,0,141,242,0,242,383
11/19/2021,WHP,CA,AWP,WE,Federal Contract Tower,0,0,0,0,0,0,0,111,0,111,0,0,111,0,111,236,0,236,347
11/20/2021,WHP,CA,AWP,WE,Federal Contract Tower,0,0,1,0,1,0,0,119,0,119,0,0,120,0,120,258,0,258,378
11/21/2021,WHP,CA,AWP,WE,Federal Contract Tower,0,0,0,0,0,0,0,33,0,33,0,0,33,0,33,18,0,18,51
11/22/2021,WHP,CA,AWP,WE,Federal Contract Tower,0,0,0,0,0,0,0,104,0,104,0,0,104,0,104,104,0,104,208
11/24/2021,WHP,CA,AWP,WE,Federal Contract Tower,0,0,1,1,2,0,0,101,0,101,0,0,102,1,103,114,0,114,217
11/25/2021,WHP,CA,AWP,WE,Federal Contract Tower,0,0,0,0,0,0,0,15,0,15,0,0,15,0,15,0,0,0,15
11/26/2021,WHP,CA,AWP,WE,Federal Contract Tower,0,0,2,0,2,0,0,129,0,129,0,0,131,0,131,172,0,172,303
11/27/2021,WHP,CA,AWP,WE,Federal Contract Tower,0,0,2,0,2,0,0,196,0,196,0,0,198,0,198,238,0,238,436
11/28/2021,WHP,CA,AWP,WE,Federal Contract Tower,0,0,1,0,1,0,0,174,0,174,0,0,175,0,175,342,0,342,517
11/29/2021,WHP,CA,AWP,WE,Federal Contract Tower,0,0,2,0,2,0,0,148,0,148,0,0,150,0,150,234,0,234,384
11/30/2021,WHP,CA,AWP,WE,Federal Contract Tower,0,0,0,0,0,0,0,85,0,85,0,0,85,0,85,128,0,128,213
12/01/2021,WHP,CA,AWP,WE,Federal Contract Tower,0,0,0,0,0,0,0,111,0,111,0,0,111,0,111,172,0,172,283
12/02/2021,WHP,CA,AWP,WE,Federal Contract Tower,0,0,1,0,1,0,0,60,0,60,0,0,61,0,61,178,0,178,239
12/03/2021,WHP,CA,AWP,WE,Federal Contract Tower,0,0,37,0,37,0,0,15,0,15,0,0,52,0,52,6,0,6,58
12/04/2021,WHP,CA,AWP,WE,Federal Contract Tower,0,0,26,0,26,0,0,33,0,33,0,0,59,0,59,90,0,90,149
12/05/2021,WHP,CA,AWP,WE,Federal Contract Tower,0,0,0,0,0,0,0,156,0,156,0,0,156,0,156,164,0,164,320
12/06/2021,WHP,CA,AWP,WE,Federal Contract Tower,0,0,2,0,2,0,0,108,0,108,0,0,110,0,110,174,0,174,284
12/07/2021,WHP,CA,AWP,WE,Federal Contract Tower,0,0,2,1,3,0,0,90,1,91,0,0,92,2,94,200,0,200,294
12/08/2021,WHP,CA,AWP,WE,Federal Contract Tower,0,0,3,0,3,0,0,152,0,152,0,0,155,0,155,196,0,196,351
12/09/2021,WHP,CA,AWP,WE,Federal Contract Tower,0,0,2,0,2,0,0,23,0,23,0,0,25,0,25,28,0,28,53
12/10/2021,WHP,CA,AWP,WE,Federal Contract Tower,0,0,0,0,0,0,0,132,0,132,0,0,132,0,132,188,0,188,320
12/11/2021,WHP,CA,AWP,WE,Federal Contract Tower,0,0,0,0,0,0,0,193,0,193,0,0,193,0,193,354,0,354,547
12/12/2021,WHP,CA,AWP,WE,Federal Contract Tower,0,0,0,0,0,0,0,190,0,190,0,0,190,0,190,268,0,268,458
12/13/2021,WHP,CA,AWP,WE,Federal Contract Tower,0,0,3,0,3,0,0,72,0,72,0,0,75,0,75,238,0,238,313
12/14/2021,WHP,CA,AWP,WE,Federal Contract Tower,0,0,2,0,2,0,0,14,0,14,0,0,16,0,16,0,0,0,16
12/15/2021,WHP,CA,AWP,WE,Federal Contract Tower,0,0,1,0,1,0,0,137,0,137,0,0,138,0,138,242,0,242,380
12/16/2021,WHP,CA,AWP,WE,Federal Contract Tower,0,0,0,0,0,0,0,49,0,49,0,0,49,0,49,112,0,112,161
12/17/2021,WHP,CA,AWP,WE,Federal Contract Tower,0,0,0,0,0,0,0,93,0,93,0,0,93,0,93,110,0,110,203
12/18/2021,WHP,CA,AWP,WE,Federal Contract Tower,0,0,0,0,0,0,0,147,0,147,0,0,147,0,147,198,0,198,345
12/19/2021,WHP,CA,AWP,WE,Federal Contract Tower,0,0,0,0,0,0,0,164,0,164,0,0,164,0,164,270,0,270,434
12/20/2021,WHP,CA,AWP,WE,Federal Contract Tower,0,0,0,0,0,0,0,172,0,172,0,0,172,0,172,334,0,334,506
12/21/2021,WHP,CA,AWP,WE,Federal Contract Tower,0,0,0,0,0,0,0,132,0,132,0,0,132,0,132,234,0,234,366
12/22/2021,WHP,CA,AWP,WE,Federal Contract Tower,0,0,1,0,1,0,0,145,0,145,0,0,146,0,146,324,0,324,470
12/23/2021,WHP,CA,AWP,WE,Federal Contract Tower,0,0,2,0,2,0,0,0,0,0,0,0,2,0,2,0,0,0,2
12/24/2021,WHP,CA,AWP,WE,Federal Contract Tower,0,0,0,0,0,0,0,23,0,23,0,0,23,0,23,0,0,0,23
12/25/2021,WHP,CA,AWP,WE,Federal Contract Tower,0,0,6,0,6,0,0,1,0,1,0,0,7,0,7,0,0,0,7
12/26/2021,WHP,CA,AWP,WE,Federal Contract Tower,0,0,0,0,0,0,0,108,0,108,0,0,108,0,108,146,0,146,254
12/27/2021,WHP,CA,AWP,WE,Federal Contract Tower,0,0,4,0,4,0,0,21,0,21,0,0,25,0,25,44,0,44,69
12/28/2021,WHP,CA,AWP,WE,Federal Contract Tower,0,0,5,0,5,0,0,117,0,117,0,0,122,0,122,314,0,314,436
12/30/2021,WHP,CA,AWP,WE,Federal Contract Tower,0,0,0,0,0,0,0,0,0,0,0,0,0,0,0,0,0,0,0
12/31/2021,WHP,CA,AWP,WE,Federal Contract Tower,0,0,0,0,0,0,0,86,0,86,0,0,86,0,86,0,0,0,86
01/01/2022,WHP,CA,AWP,WE,Federal Contract Tower,0,0,0,0,0,0,0,96,0,96,0,0,96,0,96,120,0,120,216
01/02/2022,WHP,CA,AWP,WE,Federal Contract Tower,0,0,0,0,0,0,0,125,0,125,0,0,125,0,125,266,0,266,391
01/03/2022,WHP,CA,AWP,WE,Federal Contract Tower,0,0,0,0,0,0,0,88,0,88,0,0,88,0,88,138,0,138,226
01/04/2022,WHP,CA,AWP,WE,Federal Contract Tower,0,0,0,0,0,0,0,84,0,84,0,0,84,0,84,176,0,176,260
01/05/2022,WHP,CA,AWP,WE,Federal Contract Tower,0,0,0,0,0,0,0,72,0,72,0,0,72,0,72,130,0,130,202
01/06/2022,WHP,CA,AWP,WE,Federal Contract Tower,0,0,0,0,0,0,0,125,0,125,0,0,125,0,125,242,0,242,367
01/07/2022,WHP,CA,AWP,WE,Federal Contract Tower,0,0,3,0,3,0,0,95,0,95,0,0,98,0,98,223,0,223,321
01/08/2022,WHP,CA,AWP,WE,Federal Contract Tower,0,0,1,0,1,0,0,123,0,123,0,0,124,0,124,306,0,306,430
01/09/2022,WHP,CA,AWP,WE,Federal Contract Tower,0,0,0,0,0,0,0,119,0,119,0,0,119,0,119,204,0,204,323
01/10/2022,WHP,CA,AWP,WE,Federal Contract Tower,0,0,1,0,1,0,0,42,0,42,0,0,43,0,43,56,0,56,99
01/11/2022,WHP,CA,AWP,WE,Federal Contract Tower,0,0,0,0,0,0,0,68,0,68,0,0,68,0,68,120,0,120,188
01/12/2022,WHP,CA,AWP,WE,Federal Contract Tower,0,0,1,0,1,0,0,132,0,132,0,0,133,0,133,230,0,230,363
01/13/2022,WHP,CA,AWP,WE,Federal Contract Tower,0,0,1,0,1,0,0,96,0,96,0,0,97,0,97,240,0,240,337
01/14/2022,WHP,CA,AWP,WE,Federal Contract Tower,0,0,0,0,0,0,0,87,0,87,0,0,87,0,87,96,0,96,183
01/15/2022,WHP,CA,AWP,WE,Federal Contract Tower,0,0,0,0,0,0,0,95,0,95,0,0,95,0,95,44,0,44,139
01/16/2022,WHP,CA,AWP,WE,Federal Contract Tower,0,0,1,0,1,0,0,159,0,159,0,0,160,0,160,180,0,180,340
01/17/2022,WHP,CA,AWP,WE,Federal Contract Tower,0,0,3,0,3,0,0,30,0,30,0,0,33,0,33,66,0,66,99
01/18/2022,WHP,CA,AWP,WE,Federal Contract Tower,0,0,2,0,2,0,0,92,0,92,0,0,94,0,94,268,0,268,362
01/19/2022,WHP,CA,AWP,WE,Federal Contract Tower,0,0,1,0,1,0,0,83,0,83,0,0,84,0,84,74,0,74,158
01/20/2022,WHP,CA,AWP,WE,Federal Contract Tower,0,0,0,0,0,0,0,98,0,98,0,0,98,0,98,214,0,214,312
01/21/2022,WHP,CA,AWP,WE,Federal Contract Tower,0,0,1,0,1,0,0,83,0,83,0,0,84,0,84,110,0,110,194
01/22/2022,WHP,CA,AWP,WE,Federal Contract Tower,0,0,1,0,1,0,0,33,0,33,0,0,34,0,34,0,0,0,34
01/23/2022,WHP,CA,AWP,WE,Federal Contract Tower,0,0,1,0,1,0,0,78,0,78,0,0,79,0,79,70,0,70,149
01/24/2022,WHP,CA,AWP,WE,Federal Contract Tower,0,0,1,0,1,0,0,126,0,126,0,0,127,0,127,84,0,84,211
01/25/2022,WHP,CA,AWP,WE,Federal Contract Tower,0,0,1,0,1,0,0,90,0,90,0,0,91,0,91,192,0,192,283
01/26/2022,WHP,CA,AWP,WE,Federal Contract Tower,0,0,1,0,1,0,0,128,0,128,0,0,129,0,129,126,0,126,255
01/27/2022,WHP,CA,AWP,WE,Federal Contract Tower,0,0,0,0,0,0,0,163,0,163,0,0,163,0,163,370,0,370,533
01/28/2022,WHP,CA,AWP,WE,Federal Contract Tower,0,0,2,0,2,0,0,50,0,50,0,0,52,0,52,54,0,54,106
01/29/2022,WHP,CA,AWP,WE,Federal Contract Tower,0,0,0,0,0,0,0,160,0,160,0,0,160,0,160,290,0,290,450
01/30/2022,WHP,CA,AWP,WE,Federal Contract Tower,0,0,2,0,2,0,0,195,0,195,0,0,197,0,197,226,0,226,423
01/31/2022,WHP,CA,AWP,WE,Federal Contract Tower,0,0,0,0,0,0,0,112,0,112,0,0,112,0,112,302,0,302,414
02/01/2022,WHP,CA,AWP,WE,Federal Contract Tower,0,0,0,0,0,0,0,69,0,69,0,0,69,0,69,142,0,142,211
02/02/2022,WHP,CA,AWP,WE,Federal Contract Tower,0,0,0,0,0,0,0,17,0,17,0,0,17,0,17,6,0,6,23
02/03/2022,WHP,CA,AWP,WE,Federal Contract Tower,0,0,0,0,0,0,0,93,0,93,0,0,93,0,93,154,0,154,247
02/04/2022,WHP,CA,AWP,WE,Federal Contract Tower,0,0,1,0,1,0,0,54,0,54,0,0,55,0,55,20,0,20,75
02/05/2022,WHP,CA,AWP,WE,Federal Contract Tower,0,0,2,0,2,0,0,152,0,152,0,0,154,0,154,266,0,266,420
02/06/2022,WHP,CA,AWP,WE,Federal Contract Tower,0,0,0,0,0,0,0,126,0,126,0,0,126,0,126,96,0,96,222
02/07/2022,WHP,CA,AWP,WE,Federal Contract Tower,0,0,0,0,0,0,0,81,0,81,0,0,81,0,81,180,0,180,261
02/08/2022,WHP,CA,AWP,WE,Federal Contract Tower,0,0,0,0,0,0,0,82,0,82,0,0,82,0,82,138,0,138,220
02/09/2022,WHP,CA,AWP,WE,Federal Contract Tower,0,0,1,0,1,0,0,52,0,52,0,0,53,0,53,42,0,42,95
02/10/2022,WHP,CA,AWP,WE,Federal Contract Tower,0,0,0,0,0,0,0,48,0,48,0,0,48,0,48,24,0,24,72
02/11/2022,WHP,CA,AWP,WE,Federal Contract Tower,0,0,0,0,0,0,0,165,0,165,0,0,165,0,165,278,0,278,443
02/12/2022,WHP,CA,AWP,WE,Federal Contract Tower,0,0,0,0,0,0,0,142,0,142,0,0,142,0,142,236,0,236,378
02/13/2022,WHP,CA,AWP,WE,Federal Contract Tower,0,0,1,0,1,0,0,54,0,54,0,0,55,0,55,184,0,184,239
02/14/2022,WHP,CA,AWP,WE,Federal Contract Tower,0,0,3,0,3,0,0,106,0,106,0,0,109,0,109,188,0,188,297
02/15/2022,WHP,CA,AWP,WE,Federal Contract Tower,0,0,0,0,0,0,0,23,0,23,0,0,23,0,23,10,0,10,33
02/16/2022,WHP,CA,AWP,WE,Federal Contract Tower,0,0,0,0,0,0,0,121,0,121,0,0,121,0,121,208,0,208,329
02/17/2022,WHP,CA,AWP,WE,Federal Contract Tower,0,0,0,0,0,0,0,48,0,48,0,0,48,0,48,44,0,44,92
02/18/2022,WHP,CA,AWP,WE,Federal Contract Tower,0,0,3,0,3,0,0,145,0,145,0,0,148,0,148,228,0,228,376
02/19/2022,WHP,CA,AWP,WE,Federal Contract Tower,0,0,0,0,0,0,0,187,0,187,0,0,187,0,187,240,0,240,427
02/20/2022,WHP,CA,AWP,WE,Federal Contract Tower,0,0,0,0,0,0,0,181,0,181,0,0,181,0,181,210,0,210,391
02/21/2022,WHP,CA,AWP,WE,Federal Contract Tower,0,0,0,0,0,0,0,47,0,47,0,0,47,0,47,82,0,82,129
02/22/2022,WHP,CA,AWP,WE,Federal Contract Tower,0,0,1,0,1,0,0,39,0,39,0,0,40,0,40,30,0,30,70
02/23/2022,WHP,CA,AWP,WE,Federal Contract Tower,0,0,0,0,0,0,0,42,0,42,0,0,42,0,42,40,0,40,82
02/24/2022,WHP,CA,AWP,WE,Federal Contract Tower,0,0,1,0,1,0,0,136,0,136,0,0,137,0,137,200,0,200,337
02/25/2022,WHP,CA,AWP,WE,Federal Contract Tower,0,0,4,0,4,0,0,172,0,172,0,0,176,0,176,300,0,300,476
02/26/2022,WHP,CA,AWP,WE,Federal Contract Tower,0,0,0,0,0,0,0,238,0,238,0,0,238,0,238,429,0,429,667
02/27/2022,WHP,CA,AWP,WE,Federal Contract Tower,0,0,0,0,0,0,0,138,0,138,0,0,138,0,138,220,0,220,358
02/28/2022,WHP,CA,AWP,WE,Federal Contract Tower,0,0,0,0,0,0,0,38,0,38,0,0,38,0,38,10,0,10,48
03/01/2022,WHP,CA,AWP,WE,Federal Contract Tower,0,0,0,0,0,0,0,105,0,105,0,0,105,0,105,238,0,238,343
03/02/2022,WHP,CA,AWP,WE,Federal Contract Tower,0,0,0,0,0,0,0,205,0,205,0,0,205,0,205,346,0,346,551
03/03/2022,WHP,CA,AWP,WE,Federal Contract Tower,0,0,0,0,0,0,0,118,0,118,0,0,118,0,118,292,0,292,410
03/04/2022,WHP,CA,AWP,WE,Federal Contract Tower,0,0,0,0,0,0,0,70,0,70,0,0,70,0,70,200,0,200,270
03/05/2022,WHP,CA,AWP,WE,Federal Contract Tower,0,0,0,0,0,0,0,71,0,71,0,0,71,0,71,124,0,124,195
03/06/2022,WHP,CA,AWP,WE,Federal Contract Tower,0,0,4,0,4,0,0,194,0,194,0,0,198,0,198,366,0,366,564
03/07/2022,WHP,CA,AWP,WE,Federal Contract Tower,0,0,1,0,1,0,0,37,0,37,0,0,38,0,38,22,0,22,60
03/08/2022,WHP,CA,AWP,WE,Federal Contract Tower,0,0,0,0,0,0,0,81,0,81,0,0,81,0,81,236,0,236,317
03/09/2022,WHP,CA,AWP,WE,Federal Contract Tower,0,0,0,0,0,0,0,189,0,189,0,0,189,0,189,404,0,404,593
03/10/2022,WHP,CA,AWP,WE,Federal Contract Tower,0,0,0,0,0,0,0,74,0,74,0,0,74,0,74,84,0,84,158
03/11/2022,WHP,CA,AWP,WE,Federal Contract Tower,0,0,0,0,0,0,0,140,0,140,0,0,140,0,140,408,0,408,548
03/12/2022,WHP,CA,AWP,WE,Federal Contract Tower,0,0,0,0,0,0,0,179,0,179,0,0,179,0,179,218,0,218,397
03/13/2022,WHP,CA,AWP,WE,Federal Contract Tower,0,0,0,0,0,0,0,113,0,113,0,0,113,0,113,214,0,214,327
03/14/2022,WHP,CA,AWP,WE,Federal Contract Tower,0,0,0,0,0,0,0,130,0,130,0,0,130,0,130,254,0,254,384
03/15/2022,WHP,CA,AWP,WE,Federal Contract Tower,0,0,2,0,2,0,0,160,0,160,0,0,162,0,162,510,0,510,672
03/16/2022,WHP,CA,AWP,WE,Federal Contract Tower,0,0,0,0,0,0,0,54,0,54,0,0,54,0,54,50,0,50,104
03/17/2022,WHP,CA,AWP,WE,Federal Contract Tower,0,0,0,0,0,0,0,116,0,116,0,0,116,0,116,182,0,182,298
03/18/2022,WHP,CA,AWP,WE,Federal Contract Tower,0,0,2,0,2,0,0,183,0,183,0,0,185,0,185,312,0,312,497
03/19/2022,WHP,CA,AWP,WE,Federal Contract Tower,0,0,1,0,1,0,0,134,0,134,0,0,135,0,135,221,0,221,356
03/20/2022,WHP,CA,AWP,WE,Federal Contract Tower,0,0,1,0,1,0,0,28,0,28,0,0,29,0,29,4,0,4,33
03/21/2022,WHP,CA,AWP,WE,Federal Contract Tower,0,0,0,0,0,0,0,38,0,38,0,0,38,0,38,2,0,2,40
03/22/2022,WHP,CA,AWP,WE,Federal Contract Tower,0,0,0,0,0,0,0,148,0,148,0,0,148,0,148,400,0,400,548
03/23/2022,WHP,CA,AWP,WE,Federal Contract Tower,0,0,0,0,0,0,0,163,0,163,0,0,163,0,163,354,0,354,517
03/24/2022,WHP,CA,AWP,WE,Federal Contract Tower,0,0,0,0,0,0,0,148,0,148,0,0,148,0,148,336,0,336,484
03/25/2022,WHP,CA,AWP,WE,Federal Contract Tower,0,0,0,0,0,0,0,170,0,170,0,0,170,0,170,344,0,344,514
03/26/2022,WHP,CA,AWP,WE,Federal Contract Tower,0,0,0,0,0,0,0,244,0,244,0,0,244,0,244,248,0,248,492
03/27/2022,WHP,CA,AWP,WE,Federal Contract Tower,0,0,1,0,1,0,0,75,0,75,0,0,76,0,76,261,0,261,337
03/28/2022,WHP,CA,AWP,WE,Federal Contract Tower,0,0,0,0,0,0,0,10,0,10,0,0,10,0,10,4,0,4,14
03/29/2022,WHP,CA,AWP,WE,Federal Contract Tower,0,0,2,0,2,0,0,129,0,129,0,0,131,0,131,308,0,308,439
03/30/2022,WHP,CA,AWP,WE,Federal Contract Tower,0,0,1,0,1,0,0,149,0,149,0,0,150,0,150,312,0,312,462
03/31/2022,WHP,CA,AWP,WE,Federal Contract Tower,0,0,2,0,2,0,0,114,0,114,0,0,116,0,116,274,0,274,390
04/01/2022,WHP,CA,AWP,WE,Federal Contract Tower,0,0,3,0,3,0,0,165,0,165,0,0,168,0,168,366,0,366,534
04/02/2022,WHP,CA,AWP,WE,Federal Contract Tower,0,0,6,0,6,0,0,50,0,50,0,0,56,0,56,168,0,168,224
04/03/2022,WHP,CA,AWP,WE,Federal Contract Tower,0,0,8,0,8,0,0,11,0,11,0,0,19,0,19,386,0,386,405
04/04/2022,WHP,CA,AWP,WE,Federal Contract Tower,0,0,0,0,0,0,0,74,0,74,0,0,74,0,74,24,0,24,98
04/05/2022,WHP,CA,AWP,WE,Federal Contract Tower,0,0,0,0,0,0,0,45,0,45,0,0,45,0,45,0,0,0,45
04/06/2022,WHP,CA,AWP,WE,Federal Contract Tower,0,0,0,0,0,0,0,135,0,135,0,0,135,0,135,224,0,224,359
04/07/2022,WHP,CA,AWP,WE,Federal Contract Tower,0,0,0,0,0,0,0,55,0,55,0,0,55,0,55,94,0,94,149
04/08/2022,WHP,CA,AWP,WE,Federal Contract Tower,0,0,0,0,0,0,0,107,0,107,0,0,107,0,107,234,0,234,341
04/09/2022,WHP,CA,AWP,WE,Federal Contract Tower,0,0,1,0,1,0,0,142,0,142,0,0,143,0,143,284,0,284,427
04/10/2022,WHP,CA,AWP,WE,Federal Contract Tower,0,0,3,0,3,0,0,121,0,121,0,0,124,0,124,284,0,284,408
04/11/2022,WHP,CA,AWP,WE,Federal Contract Tower,0,0,3,0,3,0,0,73,0,73,0,0,76,0,76,26,0,26,102
04/12/2022,WHP,CA,AWP,WE,Federal Contract Tower,0,0,0,0,0,0,0,42,0,42,0,0,42,0,42,16,0,16,58
04/13/2022,WHP,CA,AWP,WE,Federal Contract Tower,0,0,0,0,0,0,0,129,0,129,0,0,129,0,129,170,0,170,299
04/14/2022,WHP,CA,AWP,WE,Federal Contract Tower,0,0,0,0,0,0,0,250,0,250,0,0,250,0,250,440,0,440,690
04/15/2022,WHP,CA,AWP,WE,Federal Contract Tower,0,0,1,0,1,0,0,182,0,182,0,0,183,0,183,270,0,270,453
04/16/2022,WHP,CA,AWP,WE,Federal Contract Tower,0,0,0,0,0,0,0,118,0,118,0,0,118,0,118,278,0,278,396
04/17/2022,WHP,CA,AWP,WE,Federal Contract Tower,0,0,0,0,0,0,0,146,0,146,0,0,146,0,146,180,0,180,326
04/18/2022,WHP,CA,AWP,WE,Federal Contract Tower,0,0,1,0,1,0,0,100,0,100,0,0,101,0,101,212,0,212,313
04/19/2022,WHP,CA,AWP,WE,Federal Contract Tower,0,0,0,0,0,0,0,89,0,89,0,0,89,0,89,250,0,250,339
04/20/2022,WHP,CA,AWP,WE,Federal Contract Tower,0,0,5,0,5,0,0,85,0,85,0,0,90,0,90,146,0,146,236
04/21/2022,WHP,CA,AWP,WE,Federal Contract Tower,0,0,1,0,1,0,0,99,0,99,0,0,100,0,100,206,0,206,306
04/22/2022,WHP,CA,AWP,WE,Federal Contract Tower,0,0,2,0,2,0,0,107,0,107,0,0,109,0,109,246,0,246,355
04/23/2022,WHP,CA,AWP,WE,Federal Contract Tower,0,0,0,0,0,0,0,159,0,159,0,0,159,0,159,302,0,302,461
04/24/2022,WHP,CA,AWP,WE,Federal Contract Tower,0,0,0,0,0,0,0,50,0,50,0,0,50,0,50,34,0,34,84
04/25/2022,WHP,CA,AWP,WE,Federal Contract Tower,0,0,0,0,0,0,0,108,0,108,0,0,108,0,108,292,0,292,400
04/26/2022,WHP,CA,AWP,WE,Federal Contract Tower,0,0,0,0,0,0,0,130,0,130,0,0,130,0,130,312,0,312,442
04/27/2022,WHP,CA,AWP,WE,Federal Contract Tower,0,0,3,0,3,0,0,134,0,134,0,0,137,0,137,264,0,264,401
04/28/2022,WHP,CA,AWP,WE,Federal Contract Tower,0,0,6,0,6,0,0,73,0,73,0,0,79,0,79,216,0,216,295
04/29/2022,WHP,CA,AWP,WE,Federal Contract Tower,0,0,1,0,1,0,0,125,0,125,0,0,126,0,126,282,0,282,408
04/30/2022,WHP,CA,AWP,WE,Federal Contract Tower,0,0,1,0,1,0,0,130,0,130,0,0,131,0,131,252,0,252,383
05/01/2022,WHP,CA,AWP,WE,Federal Contract Tower,0,0,0,0,0,0,0,144,0,144,0,0,144,0,144,298,0,298,442
05/02/2022,WHP,CA,AWP,WE,Federal Contract Tower,0,0,1,0,1,0,0,101,0,101,0,0,102,0,102,274,0,274,376
05/03/2022,WHP,CA,AWP,WE,Federal Contract Tower,0,0,0,0,0,0,0,117,0,117,0,0,117,0,117,196,0,196,313
05/04/2022,WHP,CA,AWP,WE,Federal Contract Tower,0,0,2,0,2,0,0,166,0,166,0,0,168,0,168,448,0,448,616
05/05/2022,WHP,CA,AWP,WE,Federal Contract Tower,0,0,0,0,0,0,0,171,0,171,0,0,171,0,171,348,0,348,519
05/06/2022,WHP,CA,AWP,WE,Federal Contract Tower,0,0,0,0,0,0,0,125,0,125,0,0,125,0,125,186,0,186,311
05/07/2022,WHP,CA,AWP,WE,Federal Contract Tower,0,0,0,0,0,0,0,166,0,166,0,0,166,0,166,314,0,314,480
05/08/2022,WHP,CA,AWP,WE,Federal Contract Tower,0,0,2,0,2,0,0,94,0,94,0,0,96,0,96,214,0,214,310
05/09/2022,WHP,CA,AWP,WE,Federal Contract Tower,0,0,1,0,1,0,0,72,0,72,0,0,73,0,73,64,0,64,137
05/10/2022,WHP,CA,AWP,WE,Federal Contract Tower,0,0,0,0,0,0,0,74,0,74,0,0,74,0,74,36,0,36,110
05/11/2022,WHP,CA,AWP,WE,Federal Contract Tower,0,0,0,0,0,0,0,50,0,50,0,0,50,0,50,22,0,22,72
05/12/2022,WHP,CA,AWP,WE,Federal Contract Tower,0,0,3,0,3,0,0,141,0,141,0,0,144,0,144,244,0,244,388
05/13/2022,WHP,CA,AWP,WE,Federal Contract Tower,0,0,0,0,0,0,0,135,0,135,0,0,135,0,135,306,0,306,441
05/14/2022,WHP,CA,AWP,WE,Federal Contract Tower,0,0,0,0,0,0,0,155,0,155,0,0,155,0,155,216,0,216,371
05/15/2022,WHP,CA,AWP,WE,Federal Contract Tower,0,0,0,0,0,0,0,158,0,158,0,0,158,0,158,254,0,254,412
05/16/2022,WHP,CA,AWP,WE,Federal Contract Tower,0,0,2,0,2,0,0,113,0,113,0,0,115,0,115,240,0,240,355
05/17/2022,WHP,CA,AWP,WE,Federal Contract Tower,0,0,1,0,1,0,0,85,0,85,0,0,86,0,86,188,0,188,274
05/18/2022,WHP,CA,AWP,WE,Federal Contract Tower,0,0,0,0,0,0,0,128,0,128,0,0,128,0,128,300,0,300,428
05/19/2022,WHP,CA,AWP,WE,Federal Contract Tower,0,0,2,0,2,0,0,84,0,84,0,0,86,0,86,168,0,168,254
05/20/2022,WHP,CA,AWP,WE,Federal Contract Tower,0,0,0,0,0,0,0,61,0,61,0,0,61,0,61,160,0,160,221
05/21/2022,WHP,CA,AWP,WE,Federal Contract Tower,0,0,4,0,4,0,0,153,0,153,0,0,157,0,157,356,0,356,513
05/22/2022,WHP,CA,AWP,WE,Federal Contract Tower,0,0,0,0,0,0,0,139,0,139,0,0,139,0,139,326,0,326,465
05/23/2022,WHP,CA,AWP,WE,Federal Contract Tower,0,0,4,0,4,0,0,73,0,73,0,0,77,0,77,190,0,190,267
05/24/2022,WHP,CA,AWP,WE,Federal Contract Tower,0,0,2,0,2,0,0,150,0,150,0,0,152,0,152,304,0,304,456
05/25/2022,WHP,CA,AWP,WE,Federal Contract Tower,0,0,2,0,2,0,0,168,0,168,0,0,170,0,170,394,0,394,564
05/26/2022,WHP,CA,AWP,WE,Federal Contract Tower,0,0,1,0,1,0,0,125,0,125,0,0,126,0,126,324,0,324,450
05/27/2022,WHP,CA,AWP,WE,Federal Contract Tower,0,0,2,0,2,0,0,110,0,110,0,0,112,0,112,180,0,180,292
05/28/2022,WHP,CA,AWP,WE,Federal Contract Tower,0,0,5,0,5,0,0,187,0,187,0,0,192,0,192,208,0,208,400
05/29/2022,WHP,CA,AWP,WE,Federal Contract Tower,0,0,2,0,2,0,0,59,0,59,0,0,61,0,61,44,0,44,105
05/30/2022,WHP,CA,AWP,WE,Federal Contract Tower,0,0,0,0,0,0,0,125,0,125,0,0,125,0,125,154,0,154,279
05/31/2022,WHP,CA,AWP,WE,Federal Contract Tower,0,0,2,0,2,0,0,145,0,145,0,0,147,0,147,318,0,318,465
06/01/2022,WHP,CA,AWP,WE,Federal Contract Tower,0,0,0,0,0,0,0,111,0,111,0,0,111,0,111,326,0,326,437
06/02/2022,WHP,CA,AWP,WE,Federal Contract Tower,0,0,0,0,0,0,0,140,0,140,0,0,140,0,140,334,0,334,474
06/03/2022,WHP,CA,AWP,WE,Federal Contract Tower,0,0,3,0,3,0,0,93,0,93,0,0,96,0,96,194,0,194,290
06/04/2022,WHP,CA,AWP,WE,Federal Contract Tower,0,0,6,0,6,0,0,127,0,127,0,0,133,0,133,286,0,286,419
06/05/2022,WHP,CA,AWP,WE,Federal Contract Tower,0,0,4,0,4,0,0,109,0,109,0,0,113,0,113,236,0,236,349
06/06/2022,WHP,CA,AWP,WE,Federal Contract Tower,0,0,3,0,3,0,0,97,0,97,0,0,100,0,100,180,0,180,280
06/07/2022,WHP,CA,AWP,WE,Federal Contract Tower,0,0,0,0,0,0,0,89,0,89,0,0,89,0,89,334,0,334,423
06/08/2022,WHP,CA,AWP,WE,Federal Contract Tower,0,0,0,0,0,0,0,71,0,71,0,0,71,0,71,194,0,194,265
06/09/2022,WHP,CA,AWP,WE,Federal Contract Tower,0,0,1,0,1,0,0,21,0,21,0,0,22,0,22,0,0,0,22
06/10/2022,WHP,CA,AWP,WE,Federal Contract Tower,0,0,3,0,3,0,0,39,0,39,0,0,42,0,42,0,0,0,42
06/11/2022,WHP,CA,AWP,WE,Federal Contract Tower,0,0,2,0,2,0,0,102,0,102,0,0,104,0,104,64,0,64,168
06/12/2022,WHP,CA,AWP,WE,Federal Contract Tower,0,0,0,0,0,0,0,137,0,137,0,0,137,0,137,214,0,214,351
06/13/2022,WHP,CA,AWP,WE,Federal Contract Tower,0,0,1,0,1,0,0,95,0,95,0,0,96,0,96,204,0,204,300
06/14/2022,WHP,CA,AWP,WE,Federal Contract Tower,0,0,1,0,1,0,0,120,0,120,0,0,121,0,121,414,0,414,535
06/15/2022,WHP,CA,AWP,WE,Federal Contract Tower,0,0,2,0,2,0,0,97,0,97,0,0,99,0,99,316,0,316,415
06/16/2022,WHP,CA,AWP,WE,Federal Contract Tower,0,0,0,0,0,0,0,118,0,118,0,0,118,0,118,282,0,282,400
06/17/2022,WHP,CA,AWP,WE,Federal Contract Tower,0,0,1,0,1,0,0,116,0,116,0,0,117,0,117,142,0,142,259
06/18/2022,WHP,CA,AWP,WE,Federal Contract Tower,0,0,1,0,1,0,0,162,0,162,0,0,163,0,163,256,0,256,419
06/19/2022,WHP,CA,AWP,WE,Federal Contract Tower,0,0,0,0,0,0,0,98,0,98,0,0,98,0,98,102,0,102,200
06/20/2022,WHP,CA,AWP,WE,Federal Contract Tower,0,0,0,0,0,0,0,143,0,143,0,0,143,0,143,250,0,250,393
06/21/2022,WHP,CA,AWP,WE,Federal Contract Tower,0,0,1,0,1,0,0,126,0,126,0,0,127,0,127,396,0,396,523
06/22/2022,WHP,CA,AWP,WE,Federal Contract Tower,0,0,0,0,0,0,0,51,0,51,0,0,51,0,51,142,0,142,193
06/23/2022,WHP,CA,AWP,WE,Federal Contract Tower,0,1,0,0,1,0,0,115,0,115,0,1,115,0,116,316,0,316,432
06/24/2022,WHP,CA,AWP,WE,Federal Contract Tower,0,0,0,0,0,0,0,105,0,105,0,0,105,0,105,226,0,226,331
06/25/2022,WHP,CA,AWP,WE,Federal Contract Tower,0,0,2,0,2,0,0,238,0,238,0,0,240,0,240,0,0,0,240
06/26/2022,WHP,CA,AWP,WE,Federal Contract Tower,0,0,0,0,0,0,0,104,0,104,0,0,104,0,104,208,0,208,312
06/27/2022,WHP,CA,AWP,WE,Federal Contract Tower,0,0,1,0,1,0,0,95,0,95,0,0,96,0,96,146,0,146,242
06/28/2022,WHP,CA,AWP,WE,Federal Contract Tower,4,0,0,0,4,0,0,81,0,81,4,0,81,0,85,212,0,212,297
06/29/2022,WHP,CA,AWP,WE,Federal Contract Tower,0,0,0,0,0,0,0,137,0,137,0,0,137,0,137,252,0,252,389
06/30/2022,WHP,CA,AWP,WE,Federal Contract Tower,0,0,0,0,0,0,0,122,0,122,0,0,122,0,122,302,0,302,424
07/01/2022,WHP,CA,AWP,WE,Federal Contract Tower,0,0,0,0,0,0,0,113,0,113,0,0,113,0,113,276,0,276,389
07/02/2022,WHP,CA,AWP,WE,Federal Contract Tower,0,0,0,0,0,0,0,123,0,123,0,0,123,0,123,250,0,250,373
07/03/2022,WHP,CA,AWP,WE,Federal Contract Tower,0,0,1,0,1,0,0,120,0,120,0,0,121,0,121,170,0,170,291
07/04/2022,WHP,CA,AWP,WE,Federal Contract Tower,0,0,0,0,0,0,0,70,0,70,0,0,70,0,70,84,0,84,154
07/05/2022,WHP,CA,AWP,WE,Federal Contract Tower,0,0,1,0,1,0,0,68,0,68,0,0,69,0,69,96,0,96,165
07/06/2022,WHP,CA,AWP,WE,Federal Contract Tower,0,0,3,0,3,0,0,93,0,93,0,0,96,0,96,276,0,276,372
07/07/2022,WHP,CA,AWP,WE,Federal Contract Tower,0,0,3,0,3,0,0,125,0,125,0,0,128,0,128,318,0,318,446
07/08/2022,WHP,CA,AWP,WE,Federal Contract Tower,0,0,0,0,0,0,0,133,0,133,0,0,133,0,133,264,0,264,397
07/09/2022,WHP,CA,AWP,WE,Federal Contract Tower,0,0,0,0,0,0,0,112,0,112,0,0,112,0,112,182,0,182,294
07/10/2022,WHP,CA,AWP,WE,Federal Contract Tower,0,0,0,0,0,0,0,127,0,127,0,0,127,0,127,236,0,236,363
07/11/2022,WHP,CA,AWP,WE,Federal Contract Tower,0,0,0,0,0,0,0,92,0,92,0,0,92,0,92,213,0,213,305
07/12/2022,WHP,CA,AWP,WE,Federal Contract Tower,0,0,0,0,0,0,0,145,0,145,0,0,145,0,145,414,0,414,559
07/13/2022,WHP,CA,AWP,WE,Federal Contract Tower,0,0,1,0,1,0,0,135,0,135,0,0,136,0,136,296,0,296,432
07/14/2022,WHP,CA,AWP,WE,Federal Contract Tower,0,0,0,0,0,0,0,134,0,134,0,0,134,0,134,300,0,300,434
07/15/2022,WHP,CA,AWP,WE,Federal Contract Tower,0,0,0,0,0,0,0,110,0,110,0,0,110,0,110,214,0,214,324
07/16/2022,WHP,CA,AWP,WE,Federal Contract Tower,0,0,2,0,2,0,0,92,0,92,0,0,94,0,94,174,0,174,268
07/17/2022,WHP,CA,AWP,WE,Federal Contract Tower,0,0,1,0,1,0,0,99,0,99,0,0,100,0,100,142,0,142,242
07/18/2022,WHP,CA,AWP,WE,Federal Contract Tower,0,0,1,0,1,0,0,98,0,98,0,0,99,0,99,28,0,28,127
07/19/2022,WHP,CA,AWP,WE,Federal Contract Tower,0,0,1,0,1,0,0,124,0,124,0,0,125,0,125,268,0,268,393
07/20/2022,WHP,CA,AWP,WE,Federal Contract Tower,0,0,0,0,0,0,0,146,0,146,0,0,146,0,146,324,0,324,470
07/21/2022,WHP,CA,AWP,WE,Federal Contract Tower,0,0,0,0,0,0,0,111,0,111,0,0,111,0,111,202,0,202,313
07/22/2022,WHP,CA,AWP,WE,Federal Contract Tower,0,0,0,0,0,0,0,128,0,128,0,0,128,0,128,170,0,170,298
07/23/2022,WHP,CA,AWP,WE,Federal Contract Tower,0,0,0,0,0,0,0,156,0,156,0,0,156,0,156,98,0,98,254
07/24/2022,WHP,CA,AWP,WE,Federal Contract Tower,0,0,2,0,2,0,0,82,0,82,0,0,84,0,84,118,0,118,202
07/25/2022,WHP,CA,AWP,WE,Federal Contract Tower,0,0,0,0,0,0,0,114,0,114,0,0,114,0,114,246,0,246,360
07/26/2022,WHP,CA,AWP,WE,Federal Contract Tower,0,0,0,0,0,0,0,151,0,151,0,0,151,0,151,370,0,370,521
07/27/2022,WHP,CA,AWP,WE,Federal Contract Tower,0,1,0,0,1,0,0,116,0,116,0,1,116,0,117,248,0,248,365
07/28/2022,WHP,CA,AWP,WE,Federal Contract Tower,0,0,2,0,2,0,0,116,0,116,0,0,118,0,118,202,0,202,320
07/29/2022,WHP,CA,AWP,WE,Federal Contract Tower,0,0,0,0,0,0,0,123,0,123,0,0,123,0,123,231,0,231,354
07/30/2022,WHP,CA,AWP,WE,Federal Contract Tower,0,0,1,0,1,0,0,88,0,88,0,0,89,0,89,185,0,185,274
07/31/2022,WHP,CA,AWP,WE,Federal Contract Tower,0,0,0,0,0,0,0,112,0,112,0,0,112,0,112,260,0,260,372
08/01/2022,WHP,CA,AWP,WE,Federal Contract Tower,0,0,0,0,0,0,0,93,0,93,0,0,93,0,93,146,0,146,239
08/02/2022,WHP,CA,AWP,WE,Federal Contract Tower,0,0,0,0,0,0,0,142,0,142,0,0,142,0,142,230,0,230,372
08/03/2022,WHP,CA,AWP,WE,Federal Contract Tower,0,0,0,0,0,0,0,138,0,138,0,0,138,0,138,256,0,256,394
08/04/2022,WHP,CA,AWP,WE,Federal Contract Tower,0,0,0,0,0,0,0,147,0,147,0,0,147,0,147,318,0,318,465
08/05/2022,WHP,CA,AWP,WE,Federal Contract Tower,0,0,2,0,2,0,0,117,0,117,0,0,119,0,119,126,0,126,245
08/06/2022,WHP,CA,AWP,WE,Federal Contract Tower,0,0,0,0,0,0,0,94,0,94,0,0,94,0,94,142,0,142,236
08/07/2022,WHP,CA,AWP,WE,Federal Contract Tower,0,0,1,0,1,0,0,134,0,134,0,0,135,0,135,128,0,128,263
08/08/2022,WHP,CA,AWP,WE,Federal Contract Tower,0,0,0,0,0,0,0,62,0,62,0,0,62,0,62,110,0,110,172
08/09/2022,WHP,CA,AWP,WE,Federal Contract Tower,0,0,2,0,2,0,0,119,0,119,0,0,121,0,121,200,0,200,321
08/10/2022,WHP,CA,AWP,WE,Federal Contract Tower,0,0,2,0,2,0,0,118,0,118,0,0,120,0,120,174,0,174,294
08/11/2022,WHP,CA,AWP,WE,Federal Contract Tower,0,0,0,0,0,0,0,106,0,106,0,0,106,0,106,156,0,156,262
08/12/2022,WHP,CA,AWP,WE,Federal Contract Tower,0,0,0,0,0,0,0,114,0,114,0,0,114,0,114,172,0,172,286
08/13/2022,WHP,CA,AWP,WE,Federal Contract Tower,0,0,1,0,1,0,0,102,0,102,0,0,103,0,103,126,0,126,229
08/14/2022,WHP,CA,AWP,WE,Federal Contract Tower,0,0,1,0,1,0,0,131,0,131,0,0,132,0,132,78,0,78,210
08/15/2022,WHP,CA,AWP,WE,Federal Contract Tower,0,0,1,0,1,0,0,92,0,92,0,0,93,0,93,152,0,152,245
08/16/2022,WHP,CA,AWP,WE,Federal Contract Tower,0,0,0,0,0,0,0,103,0,103,0,0,103,0,103,174,0,174,277
08/17/2022,WHP,CA,AWP,WE,Federal Contract Tower,0,0,1,0,1,0,0,118,0,118,0,0,119,0,119,216,0,216,335
08/18/2022,WHP,CA,AWP,WE,Federal Contract Tower,0,0,1,0,1,0,0,137,0,137,0,0,138,0,138,226,0,226,364
08/19/2022,WHP,CA,AWP,WE,Federal Contract Tower,0,0,0,0,0,0,0,101,0,101,0,0,101,0,101,188,0,188,289
08/20/2022,WHP,CA,AWP,WE,Federal Contract Tower,0,0,2,0,2,0,0,111,0,111,0,0,113,0,113,104,0,104,217
08/21/2022,WHP,CA,AWP,WE,Federal Contract Tower,0,0,8,0,8,0,0,116,0,116,0,0,124,0,124,148,0,148,272
08/22/2022,WHP,CA,AWP,WE,Federal Contract Tower,0,0,2,0,2,0,0,81,0,81,0,0,83,0,83,170,0,170,253
08/23/2022,WHP,CA,AWP,WE,Federal Contract Tower,0,0,1,0,1,0,0,120,0,120,0,0,121,0,121,212,0,212,333
08/24/2022,WHP,CA,AWP,WE,Federal Contract Tower,0,0,0,0,0,0,0,104,0,104,0,0,104,0,104,198,0,198,302
08/25/2022,WHP,CA,AWP,WE,Federal Contract Tower,0,0,1,0,1,0,0,148,0,148,0,0,149,0,149,168,0,168,317
08/26/2022,WHP,CA,AWP,WE,Federal Contract Tower,0,0,0,0,0,0,0,124,0,124,0,0,124,0,124,192,0,192,316
08/27/2022,WHP,CA,AWP,WE,Federal Contract Tower,0,0,1,0,1,0,0,196,0,196,0,0,197,0,197,96,0,96,293
08/28/2022,WHP,CA,AWP,WE,Federal Contract Tower,0,0,3,0,3,0,0,100,0,100,0,0,103,0,103,162,0,162,265
08/29/2022,WHP,CA,AWP,WE,Federal Contract Tower,0,0,0,0,0,0,0,90,0,90,0,0,90,0,90,188,0,188,278
08/30/2022,WHP,CA,AWP,WE,Federal Contract Tower,0,0,0,0,0,0,0,82,0,82,0,0,82,0,82,106,0,106,188
08/31/2022,WHP,CA,AWP,WE,Federal Contract Tower,0,0,1,0,1,0,0,71,0,71,0,0,72,0,72,58,0,58,130
09/01/2022,WHP,CA,AWP,WE,Federal Contract Tower,0,0,1,0,1,0,0,91,0,91,0,0,92,0,92,80,0,80,172
09/02/2022,WHP,CA,AWP,WE,Federal Contract Tower,0,0,0,0,0,0,0,86,0,86,0,0,86,0,86,144,0,144,230
09/03/2022,WHP,CA,AWP,WE,Federal Contract Tower,0,0,1,0,1,0,0,73,0,73,0,0,74,0,74,96,0,96,170
09/04/2022,WHP,CA,AWP,WE,Federal Contract Tower,0,0,4,0,4,0,0,62,0,62,0,0,66,0,66,80,0,80,146
09/05/2022,WHP,CA,AWP,WE,Federal Contract Tower,0,0,0,0,0,0,0,61,0,61,0,0,61,0,61,72,0,72,133
09/06/2022,WHP,CA,AWP,WE,Federal Contract Tower,0,0,0,0,0,0,0,112,0,112,0,0,112,0,112,160,0,160,272
09/07/2022,WHP,CA,AWP,WE,Federal Contract Tower,0,0,0,0,0,0,0,103,0,103,0,0,103,0,103,120,0,120,223
09/08/2022,WHP,CA,AWP,WE,Federal Contract Tower,0,0,0,0,0,0,0,87,0,87,0,0,87,0,87,84,0,84,171
09/09/2022,WHP,CA,AWP,WE,Federal Contract Tower,0,0,0,0,0,0,0,73,0,73,0,0,73,0,73,112,0,112,185
09/10/2022,WHP,CA,AWP,WE,Federal Contract Tower,0,0,1,0,1,0,0,37,0,37,0,0,38,0,38,120,0,120,158
09/11/2022,WHP,CA,AWP,WE,Federal Contract Tower,0,0,2,0,2,0,0,67,0,67,0,0,69,0,69,156,0,156,225
09/12/2022,WHP,CA,AWP,WE,Federal Contract Tower,0,0,0,0,0,0,0,86,0,86,0,0,86,0,86,224,0,224,310
09/13/2022,WHP,CA,AWP,WE,Federal Contract Tower,0,0,0,0,0,0,0,129,0,129,0,0,129,0,129,150,0,150,279
09/14/2022,WHP,CA,AWP,WE,Federal Contract Tower,0,0,2,0,2,0,0,97,0,97,0,0,99,0,99,144,0,144,243
09/15/2022,WHP,CA,AWP,WE,Federal Contract Tower,0,0,0,0,0,0,0,128,0,128,0,0,128,0,128,258,0,258,386
09/16/2022,WHP,CA,AWP,WE,Federal Contract Tower,0,0,0,0,0,0,0,100,0,100,0,0,100,0,100,203,0,203,303
09/17/2022,WHP,CA,AWP,WE,Federal Contract Tower,0,0,2,0,2,0,0,48,0,48,0,0,50,0,50,234,0,234,284
09/18/2022,WHP,CA,AWP,WE,Federal Contract Tower,0,0,0,0,0,0,0,103,0,103,0,0,103,0,103,190,0,190,293
09/19/2022,WHP,CA,AWP,WE,Federal Contract Tower,0,0,0,0,0,0,0,100,0,100,0,0,100,0,100,194,0,194,294
09/20/2022,WHP,CA,AWP,WE,Federal Contract Tower,0,0,0,0,0,0,0,113,0,113,0,0,113,0,113,210,0,210,323
09/21/2022,WHP,CA,AWP,WE,Federal Contract Tower,0,0,0,0,0,0,0,76,0,76,0,0,76,0,76,116,0,116,192
09/22/2022,WHP,CA,AWP,WE,Federal Contract Tower,0,0,1,0,1,0,0,112,0,112,0,0,113,0,113,136,0,136,249
09/23/2022,WHP,CA,AWP,WE,Federal Contract Tower,0,0,0,0,0,0,0,108,0,108,0,0,108,0,108,92,0,92,200
09/24/2022,WHP,CA,AWP,WE,Federal Contract Tower,0,0,0,0,0,0,0,172,0,172,0,0,172,0,172,38,0,38,210
09/25/2022,WHP,CA,AWP,WE,Federal Contract Tower,0,0,0,0,0,0,0,129,0,129,0,0,129,0,129,98,0,98,227
09/26/2022,WHP,CA,AWP,WE,Federal Contract Tower,0,0,0,0,0,0,0,91,0,91,0,0,91,0,91,52,0,52,143
09/27/2022,WHP,CA,AWP,WE,Federal Contract Tower,0,0,0,0,0,0,0,120,0,120,0,0,120,0,120,154,0,154,274
09/28/2022,WHP,CA,AWP,WE,Federal Contract Tower,0,0,1,0,1,0,0,91,0,91,0,0,92,0,92,188,0,188,280
09/29/2022,WHP,CA,AWP,WE,Federal Contract Tower,0,0,0,0,0,0,0,131,0,131,0,0,131,0,131,198,0,198,329
09/30/2022,WHP,CA,AWP,WE,Federal Contract Tower,0,0,3,0,3,0,0,99,0,99,0,0,102,0,102,50,0,50,152
10/01/2022,WHP,CA,AWP,WE,Federal Contract Tower,0,0,3,0,3,0,0,103,0,103,0,0,106,0,106,160,0,160,266
10/02/2022,WHP,CA,AWP,WE,Federal Contract Tower,0,0,2,0,2,0,0,140,0,140,0,0,142,0,142,204,0,204,346
10/03/2022,WHP,CA,AWP,WE,Federal Contract Tower,0,0,0,0,0,0,0,78,0,78,0,0,78,0,78,114,0,114,192
10/04/2022,WHP,CA,AWP,WE,Federal Contract Tower,0,0,0,0,0,0,0,122,0,122,0,0,122,0,122,142,0,142,264
10/05/2022,WHP,CA,AWP,WE,Federal Contract Tower,0,0,0,0,0,0,0,100,0,100,0,0,100,0,100,222,0,222,322
10/06/2022,WHP,CA,AWP,WE,Federal Contract Tower,0,0,2,0,2,0,0,84,0,84,0,0,86,0,86,166,0,166,252
10/07/2022,WHP,CA,AWP,WE,Federal Contract Tower,0,0,4,0,4,0,0,77,0,77,0,0,81,0,81,54,0,54,135
10/08/2022,WHP,CA,AWP,WE,Federal Contract Tower,0,0,1,0,1,0,0,112,0,112,0,0,113,0,113,128,0,128,241
10/09/2022,WHP,CA,AWP,WE,Federal Contract Tower,0,0,0,0,0,0,0,139,0,139,0,0,139,0,139,208,0,208,347
10/10/2022,WHP,CA,AWP,WE,Federal Contract Tower,0,0,1,0,1,0,0,68,0,68,0,0,69,0,69,150,0,150,219
10/11/2022,WHP,CA,AWP,WE,Federal Contract Tower,0,0,1,0,1,0,0,95,0,95,0,0,96,0,96,180,0,180,276
10/12/2022,WHP,CA,AWP,WE,Federal Contract Tower,0,0,1,0,1,0,0,61,0,61,0,0,62,0,62,110,0,110,172
10/13/2022,WHP,CA,AWP,WE,Federal Contract Tower,0,0,2,0,2,0,0,33,0,33,0,0,35,0,35,2,0,2,37
10/14/2022,WHP,CA,AWP,WE,Federal Contract Tower,0,0,0,0,0,0,0,36,0,36,0,0,36,0,36,38,0,38,74
10/15/2022,WHP,CA,AWP,WE,Federal Contract Tower,0,0,4,0,4,0,0,12,0,12,0,0,16,0,16,10,0,10,26
10/16/2022,WHP,CA,AWP,WE,Federal Contract Tower,0,0,17,0,17,0,0,92,0,92,0,0,109,0,109,262,0,262,371
10/17/2022,WHP,CA,AWP,WE,Federal Contract Tower,0,0,0,0,0,0,0,121,0,121,0,0,121,0,121,160,0,160,281
10/18/2022,WHP,CA,AWP,WE,Federal Contract Tower,0,0,0,0,0,0,0,121,0,121,0,0,121,0,121,132,0,132,253
10/19/2022,WHP,CA,AWP,WE,Federal Contract Tower,0,0,1,0,1,0,0,91,0,91,0,0,92,0,92,158,0,158,250
10/20/2022,WHP,CA,AWP,WE,Federal Contract Tower,0,0,0,0,0,0,0,121,0,121,0,0,121,0,121,207,0,207,328
10/21/2022,WHP,CA,AWP,WE,Federal Contract Tower,0,0,0,0,0,0,0,139,0,139,0,0,139,0,139,140,0,140,279
10/22/2022,WHP,CA,AWP,WE,Federal Contract Tower,0,0,11,0,11,0,0,118,0,118,0,0,129,0,129,132,0,132,261
10/23/2022,WHP,CA,AWP,WE,Federal Contract Tower,0,0,0,0,0,0,0,80,0,80,0,0,80,0,80,88,0,88,168
10/24/2022,WHP,CA,AWP,WE,Federal Contract Tower,0,0,0,0,0,0,0,86,0,86,0,0,86,0,86,148,0,148,234
10/25/2022,WHP,CA,AWP,WE,Federal Contract Tower,0,0,0,0,0,0,0,132,0,132,0,0,132,0,132,252,0,252,384
10/26/2022,WHP,CA,AWP,WE,Federal Contract Tower,0,0,0,0,0,0,0,104,0,104,0,0,104,0,104,156,0,156,260
10/27/2022,WHP,CA,AWP,WE,Federal Contract Tower,0,0,1,0,1,0,0,83,0,83,0,0,84,0,84,202,0,202,286
10/28/2022,WHP,CA,AWP,WE,Federal Contract Tower,0,0,0,0,0,0,0,196,0,196,0,0,196,0,196,188,0,188,384
10/29/2022,WHP,CA,AWP,WE,Federal Contract Tower,0,0,1,0,1,0,0,115,0,115,0,0,116,0,116,90,0,90,206
10/30/2022,WHP,CA,AWP,WE,Federal Contract Tower,0,0,0,0,0,0,0,142,0,142,0,0,142,0,142,242,0,242,384
10/31/2022,WHP,CA,AWP,WE,Federal Contract Tower,0,0,2,0,2,0,0,76,0,76,0,0,78,0,78,144,0,144,222
11/01/2022,WHP,CA,AWP,WE,Federal Contract Tower,0,0,0,0,0,0,0,75,0,75,0,0,75,0,75,174,0,174,249
11/02/2022,WHP,CA,AWP,WE,Federal Contract Tower,0,0,0,0,0,0,0,50,0,50,0,0,50,0,50,74,0,74,124
11/03/2022,WHP,CA,AWP,WE,Federal Contract Tower,0,0,0,0,0,0,0,60,0,60,0,0,60,0,60,16,0,16,76
11/04/2022,WHP,CA,AWP,WE,Federal Contract Tower,0,0,2,0,2,0,0,130,0,130,0,0,132,0,132,218,0,218,350
11/05/2022,WHP,CA,AWP,WE,Federal Contract Tower,0,0,1,0,1,0,0,143,0,143,0,0,144,0,144,234,0,234,378
11/06/2022,WHP,CA,AWP,WE,Federal Contract Tower,0,0,1,0,1,0,0,149,0,149,0,0,150,0,150,280,0,280,430
11/07/2022,WHP,CA,AWP,WE,Federal Contract Tower,0,0,0,0,0,0,0,4,0,4,0,0,4,0,4,0,0,0,4
11/08/2022,WHP,CA,AWP,WE,Federal Contract Tower,0,0,0,0,0,0,0,34,0,34,0,0,34,0,34,0,0,0,34
11/09/2022,WHP,CA,AWP,WE,Federal Contract Tower,0,0,6,0,6,0,0,109,0,109,0,0,115,0,115,159,0,159,274
11/10/2022,WHP,CA,AWP,WE,Federal Contract Tower,0,0,1,0,1,0,0,141,0,141,0,0,142,0,142,328,0,328,470
11/11/2022,WHP,CA,AWP,WE,Federal Contract Tower,0,0,0,0,0,0,0,174,0,174,0,0,174,0,174,296,0,296,470
11/12/2022,WHP,CA,AWP,WE,Federal Contract Tower,0,0,0,0,0,0,0,164,0,164,0,0,164,0,164,4,0,4,168
11/13/2022,WHP,CA,AWP,WE,Federal Contract Tower,0,0,2,0,2,0,0,41,0,41,0,0,43,0,43,8,0,8,51
11/14/2022,WHP,CA,AWP,WE,Federal Contract Tower,0,0,0,0,0,0,0,127,0,127,0,0,127,0,127,218,0,218,345
11/15/2022,WHP,CA,AWP,WE,Federal Contract Tower,0,0,0,0,0,0,0,82,0,82,0,0,82,0,82,148,0,148,230
11/16/2022,WHP,CA,AWP,WE,Federal Contract Tower,0,0,0,0,0,0,0,22,0,22,0,0,22,0,22,0,0,0,22
11/17/2022,WHP,CA,AWP,WE,Federal Contract Tower,0,0,0,0,0,0,0,172,0,172,0,0,172,0,172,300,0,300,472
11/18/2022,WHP,CA,AWP,WE,Federal Contract Tower,0,0,1,0,1,0,0,138,0,138,0,0,139,0,139,194,0,194,333
11/19/2022,WHP,CA,AWP,WE,Federal Contract Tower,0,0,0,0,0,0,0,30,0,30,0,0,30,0,30,8,0,8,38
11/20/2022,WHP,CA,AWP,WE,Federal Contract Tower,0,0,0,0,0,0,0,153,0,153,0,0,153,0,153,128,0,128,281
11/21/2022,WHP,CA,AWP,WE,Federal Contract Tower,0,0,0,0,0,0,0,113,0,113,0,0,113,0,113,184,0,184,297
11/22/2022,WHP,CA,AWP,WE,Federal Contract Tower,0,0,4,0,4,0,0,157,0,157,0,0,161,0,161,400,0,400,561
11/23/2022,WHP,CA,AWP,WE,Federal Contract Tower,0,0,2,0,2,0,0,115,0,115,0,0,117,0,117,158,0,158,275
11/24/2022,WHP,CA,AWP,WE,Federal Contract Tower,0,0,0,0,0,0,0,17,0,17,0,0,17,0,17,0,0,0,17
11/25/2022,WHP,CA,AWP,WE,Federal Contract Tower,0,0,0,0,0,0,0,105,0,105,0,0,105,0,105,132,0,132,237
11/26/2022,WHP,CA,AWP,WE,Federal Contract Tower,0,0,0,0,0,0,0,189,0,189,0,0,189,0,189,92,0,92,281
11/27/2022,WHP,CA,AWP,WE,Federal Contract Tower,0,0,0,0,0,0,0,144,0,144,0,0,144,0,144,280,0,280,424
11/28/2022,WHP,CA,AWP,WE,Federal Contract Tower,0,0,6,0,6,0,0,43,0,43,0,0,49,0,49,64,0,64,113
11/29/2022,WHP,CA,AWP,WE,Federal Contract Tower,0,0,0,0,0,0,0,124,0,124,0,0,124,0,124,292,0,292,416
11/30/2022,WHP,CA,AWP,WE,Federal Contract Tower,0,0,5,0,5,0,0,80,0,80,0,0,85,0,85,114,0,114,199
12/01/2022,WHP,CA,AWP,WE,Federal Contract Tower,0,0,0,0,0,0,0,58,0,58,0,0,58,0,58,96,0,96,154
12/02/2022,WHP,CA,AWP,WE,Federal Contract Tower,0,0,4,0,4,0,0,12,0,12,0,0,16,0,16,10,0,10,26
12/03/2022,WHP,CA,AWP,WE,Federal Contract Tower,0,0,3,0,3,0,0,113,0,113,0,0,116,0,116,198,0,198,314
12/04/2022,WHP,CA,AWP,WE,Federal Contract Tower,0,0,5,0,5,0,0,6,0,6,0,0,11,0,11,8,0,8,19
12/05/2022,WHP,CA,AWP,WE,Federal Contract Tower,0,0,0,0,0,0,0,68,0,68,0,0,68,0,68,220,0,220,288
12/06/2022,WHP,CA,AWP,WE,Federal Contract Tower,0,0,1,0,1,0,0,120,0,120,0,0,121,0,121,304,0,304,425
12/07/2022,WHP,CA,AWP,WE,Federal Contract Tower,0,0,1,0,1,0,0,136,0,136,0,0,137,0,137,317,0,317,454
12/08/2022,WHP,CA,AWP,WE,Federal Contract Tower,0,0,0,0,0,0,0,126,0,126,0,0,126,0,126,242,0,242,368
12/09/2022,WHP,CA,AWP,WE,Federal Contract Tower,0,0,0,0,0,0,0,120,0,120,0,0,120,0,120,214,0,214,334
12/10/2022,WHP,CA,AWP,WE,Federal Contract Tower,0,0,0,0,0,0,0,27,0,27,0,0,27,0,27,80,0,80,107
12/11/2022,WHP,CA,AWP,WE,Federal Contract Tower,0,0,1,0,1,0,0,5,0,5,0,0,6,0,6,6,0,6,12
12/12/2022,WHP,CA,AWP,WE,Federal Contract Tower,0,0,1,0,1,0,0,43,0,43,0,0,44,0,44,222,0,222,266
12/13/2022,WHP,CA,AWP,WE,Federal Contract Tower,0,0,0,0,0,0,0,141,0,141,0,0,141,0,141,410,0,410,551
12/14/2022,WHP,CA,AWP,WE,Federal Contract Tower,0,0,2,0,2,0,0,118,0,118,0,0,120,0,120,298,0,298,418
12/15/2022,WHP,CA,AWP,WE,Federal Contract Tower,0,0,0,0,0,0,0,127,0,127,0,0,127,0,127,210,0,210,337
12/16/2022,WHP,CA,AWP,WE,Federal Contract Tower,0,0,0,0,0,0,0,108,0,108,0,0,108,0,108,254,0,254,362
12/17/2022,WHP,CA,AWP,WE,Federal Contract Tower,0,0,3,0,3,0,0,136,0,136,0,0,139,0,139,94,0,94,233
12/18/2022,WHP,CA,AWP,WE,Federal Contract Tower,0,0,0,0,0,0,0,161,0,161,0,0,161,0,161,256,0,256,417
12/19/2022,WHP,CA,AWP,WE,Federal Contract Tower,0,0,0,0,0,0,0,122,0,122,0,0,122,0,122,176,0,176,298
12/20/2022,WHP,CA,AWP,WE,Federal Contract Tower,0,0,3,0,3,0,0,141,0,141,0,0,144,0,144,332,0,332,476
12/21/2022,WHP,CA,AWP,WE,Federal Contract Tower,0,0,0,0,0,0,0,100,0,100,0,0,100,0,100,228,0,228,328
12/22/2022,WHP,CA,AWP,WE,Federal Contract Tower,0,0,3,0,3,0,0,108,0,108,0,0,111,0,111,230,0,230,341
12/23/2022,WHP,CA,AWP,WE,Federal Contract Tower,0,0,2,0,2,0,0,111,0,111,0,0,113,0,113,141,0,141,254
12/24/2022,WHP,CA,AWP,WE,Federal Contract Tower,0,0,0,0,0,0,0,71,0,71,0,0,71,0,71,37,0,37,108
12/25/2022,WHP,CA,AWP,WE,Federal Contract Tower,0,0,1,0,1,0,0,48,0,48,0,0,49,0,49,0,0,0,49
12/26/2022,WHP,CA,AWP,WE,Federal Contract Tower,0,0,1,0,1,0,0,94,0,94,0,0,95,0,95,160,0,160,255
12/27/2022,WHP,CA,AWP,WE,Federal Contract Tower,0,0,1,0,1,0,0,72,0,72,0,0,73,0,73,104,0,104,177
12/28/2022,WHP,CA,AWP,WE,Federal Contract Tower,0,0,4,0,4,0,0,81,0,81,0,0,85,0,85,114,0,114,199
12/29/2022,WHP,CA,AWP,WE,Federal Contract Tower,0,0,3,0,3,0,0,24,0,24,0,0,27,0,27,16,0,16,43
12/30/2022,WHP,CA,AWP,WE,Federal Contract Tower,0,0,10,0,10,0,0,8,0,8,0,0,18,0,18,12,0,12,30
12/31/2022,WHP,CA,AWP,WE,Federal Contract Tower,0,0,0,0,0,0,0,0,0,0,0,0,0,0,0,0,0,0,0
01/01/2023,WHP,CA,AWP,WE,Federal Contract Tower,0,0,1,0,1,0,0,38,0,38,0,0,39,0,39,60,0,60,99
01/02/2023,WHP,CA,AWP,WE,Federal Contract Tower,0,0,0,0,0,0,0,74,0,74,0,0,74,0,74,154,0,154,228
01/03/2023,WHP,CA,AWP,WE,Federal Contract Tower,0,0,0,0,0,0,0,9,0,9,0,0,9,0,9,2,0,2,11
01/04/2023,WHP,CA,AWP,WE,Federal Contract Tower,0,0,3,0,3,0,0,4,0,4,0,0,7,0,7,10,0,10,17
01/05/2023,WHP,CA,AWP,WE,Federal Contract Tower,0,0,0,0,0,0,0,18,0,18,0,0,18,0,18,0,0,0,18
01/06/2023,WHP,CA,AWP,WE,Federal Contract Tower,0,0,1,0,1,0,0,135,0,135,0,0,136,0,136,242,0,242,378
01/07/2023,WHP,CA,AWP,WE,Federal Contract Tower,0,0,4,0,4,0,0,96,0,96,0,0,100,0,100,156,0,156,256
01/08/2023,WHP,CA,AWP,WE,Federal Contract Tower,0,0,1,0,1,0,0,73,0,73,0,0,74,0,74,134,0,134,208
01/09/2023,WHP,CA,AWP,WE,Federal Contract Tower,0,0,0,0,0,0,0,0,0,0,0,0,0,0,0,0,0,0,0
01/10/2023,WHP,CA,AWP,WE,Federal Contract Tower,0,0,0,0,0,0,0,26,0,26,0,0,26,0,26,0,0,0,26
01/11/2023,WHP,CA,AWP,WE,Federal Contract Tower,0,0,1,0,1,0,0,118,0,118,0,0,119,0,119,198,0,198,317
01/12/2023,WHP,CA,AWP,WE,Federal Contract Tower,0,0,0,0,0,0,0,123,0,123,0,0,123,0,123,250,0,250,373
01/13/2023,WHP,CA,AWP,WE,Federal Contract Tower,0,0,2,0,2,0,0,100,0,100,0,0,102,0,102,254,0,254,356
01/14/2023,WHP,CA,AWP,WE,Federal Contract Tower,0,0,3,0,3,0,0,0,0,0,0,0,3,0,3,6,0,6,9
01/15/2023,WHP,CA,AWP,WE,Federal Contract Tower,0,0,2,0,2,0,0,23,0,23,0,0,25,0,25,86,0,86,111
01/16/2023,WHP,CA,AWP,WE,Federal Contract Tower,0,0,3,0,3,0,0,26,0,26,0,0,29,0,29,10,0,10,39
01/17/2023,WHP,CA,AWP,WE,Federal Contract Tower,0,0,1,0,1,0,0,66,0,66,0,0,67,0,67,223,0,223,290
01/18/2023,WHP,CA,AWP,WE,Federal Contract Tower,0,0,3,0,3,0,0,129,0,129,0,0,132,0,132,248,0,248,380
01/19/2023,WHP,CA,AWP,WE,Federal Contract Tower,0,0,1,0,1,0,0,66,0,66,0,0,67,0,67,198,0,198,265
01/20/2023,WHP,CA,AWP,WE,Federal Contract Tower,0,0,4,0,4,0,0,107,0,107,0,0,111,0,111,129,0,129,240
01/21/2023,WHP,CA,AWP,WE,Federal Contract Tower,0,0,2,0,2,0,0,154,0,154,0,0,156,0,156,172,0,172,328
01/22/2023,WHP,CA,AWP,WE,Federal Contract Tower,0,0,0,0,0,0,0,89,0,89,0,0,89,0,89,134,0,134,223
01/23/2023,WHP,CA,AWP,WE,Federal Contract Tower,0,0,1,0,1,0,0,20,0,20,0,0,21,0,21,0,0,0,21
01/24/2023,WHP,CA,AWP,WE,Federal Contract Tower,0,0,2,0,2,0,0,71,0,71,0,0,73,0,73,168,0,168,241
01/25/2023,WHP,CA,AWP,WE,Federal Contract Tower,0,0,3,0,3,0,0,86,2,88,0,0,89,2,91,114,0,114,205
01/26/2023,WHP,CA,AWP,WE,Federal Contract Tower,0,0,0,0,0,0,0,28,0,28,0,0,28,0,28,0,0,0,28
01/27/2023,WHP,CA,AWP,WE,Federal Contract Tower,0,0,2,0,2,0,0,117,0,117,0,0,119,0,119,258,0,258,377
01/28/2023,WHP,CA,AWP,WE,Federal Contract Tower,0,0,3,0,3,0,0,274,0,274,0,0,277,0,277,94,0,94,371
01/29/2023,WHP,CA,AWP,WE,Federal Contract Tower,0,0,0,0,0,0,0,23,0,23,0,0,23,0,23,94,0,94,117
01/30/2023,WHP,CA,AWP,WE,Federal Contract Tower,0,0,0,0,0,0,0,42,0,42,0,0,42,0,42,68,0,68,110
01/31/2023,WHP,CA,AWP,WE,Federal Contract Tower,0,0,0,0,0,0,0,50,0,50,0,0,50,0,50,16,0,16,66
02/01/2023,WHP,CA,AWP,WE,Federal Contract Tower,0,0,1,0,1,0,0,85,0,85,0,0,86,0,86,88,0,88,174
02/02/2023,WHP,CA,AWP,WE,Federal Contract Tower,0,0,2,0,2,0,0,130,0,130,0,0,132,0,132,210,0,210,342
02/03/2023,WHP,CA,AWP,WE,Federal Contract Tower,0,0,4,0,4,0,0,105,0,105,0,0,109,0,109,220,0,220,329
02/04/2023,WHP,CA,AWP,WE,Federal Contract Tower,0,0,0,0,0,0,0,126,0,126,0,0,126,0,126,100,0,100,226
02/05/2023,WHP,CA,AWP,WE,Federal Contract Tower,0,0,0,0,0,0,0,42,0,42,0,0,42,0,42,122,0,122,164
02/06/2023,WHP,CA,AWP,WE,Federal Contract Tower,0,0,0,0,0,0,0,48,0,48,0,0,48,0,48,20,0,20,68
02/07/2023,WHP,CA,AWP,WE,Federal Contract Tower,0,0,1,0,1,0,0,91,0,91,0,0,92,0,92,216,0,216,308
02/08/2023,WHP,CA,AWP,WE,Federal Contract Tower,0,0,1,0,1,0,0,132,0,132,0,0,133,0,133,248,0,248,381
02/09/2023,WHP,CA,AWP,WE,Federal Contract Tower,0,0,0,0,0,0,0,85,0,85,0,0,85,0,85,132,0,132,217
02/10/2023,WHP,CA,AWP,WE,Federal Contract Tower,0,0,1,0,1,0,0,124,0,124,0,0,125,0,125,214,0,214,339
02/11/2023,WHP,CA,AWP,WE,Federal Contract Tower,0,0,1,0,1,0,0,81,0,81,0,0,82,0,82,104,0,104,186
02/12/2023,WHP,CA,AWP,WE,Federal Contract Tower,0,0,0,0,0,0,0,95,0,95,0,0,95,0,95,186,0,186,281
02/13/2023,WHP,CA,AWP,WE,Federal Contract Tower,0,0,1,0,1,0,0,81,0,81,0,0,82,0,82,146,0,146,228
02/14/2023,WHP,CA,AWP,WE,Federal Contract Tower,0,0,0,0,0,0,0,50,0,50,0,0,50,0,50,138,0,138,188
02/15/2023,WHP,CA,AWP,WE,Federal Contract Tower,0,0,1,0,1,0,0,44,0,44,0,0,45,0,45,60,0,60,105
02/16/2023,WHP,CA,AWP,WE,Federal Contract Tower,0,0,0,0,0,0,0,116,0,116,0,0,116,0,116,248,0,248,364
02/17/2023,WHP,CA,AWP,WE,Federal Contract Tower,0,0,1,0,1,0,0,80,0,80,0,0,81,0,81,20,0,20,101
02/18/2023,WHP,CA,AWP,WE,Federal Contract Tower,0,0,1,0,1,0,0,109,0,109,0,0,110,0,110,170,0,170,280
02/19/2023,WHP,CA,AWP,WE,Federal Contract Tower,0,0,0,0,0,0,0,116,0,116,0,0,116,0,116,190,0,190,306
02/20/2023,WHP,CA,AWP,WE,Federal Contract Tower,0,0,1,0,1,0,0,103,0,103,0,0,104,0,104,124,0,124,228
02/22/2023,WHP,CA,AWP,WE,Federal Contract Tower,0,0,0,0,0,0,0,32,0,32,0,0,32,0,32,4,0,4,36
02/23/2023,WHP,CA,AWP,WE,Federal Contract Tower,0,0,2,0,2,0,0,14,0,14,0,0,16,0,16,24,0,24,40
02/24/2023,WHP,CA,AWP,WE,Federal Contract Tower,0,0,3,0,3,0,0,2,0,2,0,0,5,0,5,0,0,0,5
02/25/2023,WHP,CA,AWP,WE,Federal Contract Tower,0,0,0,0,0,0,0,10,0,10,0,0,10,0,10,0,0,0,10
02/26/2023,WHP,CA,AWP,WE,Federal Contract Tower,0,0,0,0,0,0,0,121,0,121,0,0,121,0,121,158,0,158,279
02/27/2023,WHP,CA,AWP,WE,Federal Contract Tower,0,0,0,0,0,0,0,2,0,2,0,0,2,0,2,0,0,0,2
02/28/2023,WHP,CA,AWP,WE,Federal Contract Tower,0,0,0,0,0,0,0,37,0,37,0,0,37,0,37,26,0,26,63
03/01/2023,WHP,CA,AWP,WE,Federal Contract Tower,0,0,0,0,0,0,0,28,0,28,0,0,28,0,28,18,0,18,46
03/02/2023,WHP,CA,AWP,WE,Federal Contract Tower,0,0,1,0,1,0,0,157,0,157,0,0,158,0,158,280,0,280,438
03/03/2023,WHP,CA,AWP,WE,Federal Contract Tower,0,0,0,0,0,0,0,134,0,134,0,0,134,0,134,13,0,13,147
03/04/2023,WHP,CA,AWP,WE,Federal Contract Tower,0,0,4,0,4,0,0,68,0,68,0,0,72,0,72,14,0,14,86
03/05/2023,WHP,CA,AWP,WE,Federal Contract Tower,0,0,0,0,0,0,0,58,0,58,0,0,58,0,58,130,0,130,188
03/06/2023,WHP,CA,AWP,WE,Federal Contract Tower,0,0,3,0,3,0,0,83,0,83,0,0,86,0,86,254,0,254,340
03/07/2023,WHP,CA,AWP,WE,Federal Contract Tower,0,0,0,0,0,0,0,144,0,144,0,0,144,0,144,350,0,350,494
03/08/2023,WHP,CA,AWP,WE,Federal Contract Tower,0,0,0,0,0,0,0,154,0,154,0,0,154,0,154,368,0,368,522
03/09/2023,WHP,CA,AWP,WE,Federal Contract Tower,0,0,0,0,0,0,0,171,0,171,0,0,171,0,171,354,0,354,525
03/10/2023,WHP,CA,AWP,WE,Federal Contract Tower,0,0,1,0,1,0,0,0,0,0,0,0,1,0,1,0,0,0,1
03/11/2023,WHP,CA,AWP,WE,Federal Contract Tower,0,0,4,0,4,0,0,2,0,2,0,0,6,0,6,0,0,0,6
03/12/2023,WHP,CA,AWP,WE,Federal Contract Tower,0,0,4,0,4,0,0,120,0,120,0,0,124,0,124,224,0,224,348
03/13/2023,WHP,CA,AWP,WE,Federal Contract Tower,0,0,5,0,5,0,0,62,0,62,0,0,67,0,67,134,0,134,201
03/14/2023,WHP,CA,AWP,WE,Federal Contract Tower,0,0,3,0,3,0,0,0,0,0,0,0,3,0,3,6,0,6,9
03/15/2023,WHP,CA,AWP,WE,Federal Contract Tower,0,0,2,0,2,0,0,27,0,27,0,0,29,0,29,16,0,16,45
03/16/2023,WHP,CA,AWP,WE,Federal Contract Tower,0,0,3,0,3,0,0,96,0,96,0,0,99,0,99,256,0,256,355
03/17/2023,WHP,CA,AWP,WE,Federal Contract Tower,0,0,0,0,0,0,0,124,0,124,0,0,124,0,124,238,0,238,362
03/18/2023,WHP,CA,AWP,WE,Federal Contract Tower,0,0,0,0,0,0,0,154,0,154,0,0,154,0,154,214,0,214,368
03/19/2023,WHP,CA,AWP,WE,Federal Contract Tower,0,0,1,0,1,0,0,43,0,43,0,0,44,0,44,94,0,94,138
03/20/2023,WHP,CA,AWP,WE,Federal Contract Tower,0,0,1,0,1,0,0,49,0,49,0,0,50,0,50,222,0,222,272
03/21/2023,WHP,CA,AWP,WE,Federal Contract Tower,0,0,0,0,0,0,0,11,0,11,0,0,11,0,11,0,0,0,11
03/22/2023,WHP,CA,AWP,WE,Federal Contract Tower,0,0,1,0,1,0,0,30,0,30,0,0,31,0,31,20,0,20,51
03/23/2023,WHP,CA,AWP,WE,Federal Contract Tower,0,0,0,0,0,0,0,71,0,71,0,0,71,0,71,174,0,174,245
03/24/2023,WHP,CA,AWP,WE,Federal Contract Tower,0,0,0,0,0,0,0,64,0,64,0,0,64,0,64,20,0,20,84
03/25/2023,WHP,CA,AWP,WE,Federal Contract Tower,0,0,0,0,0,0,0,198,0,198,0,0,198,0,198,106,0,106,304
03/26/2023,WHP,CA,AWP,WE,Federal Contract Tower,0,0,0,0,0,0,0,28,0,28,0,0,28,0,28,8,0,8,36
03/27/2023,WHP,CA,AWP,WE,Federal Contract Tower,0,0,1,0,1,0,0,99,0,99,0,0,100,0,100,92,0,92,192
03/28/2023,WHP,CA,AWP,WE,Federal Contract Tower,0,0,0,0,0,0,0,127,0,127,0,0,127,0,127,94,0,94,221
03/29/2023,WHP,CA,AWP,WE,Federal Contract Tower,0,0,0,0,0,0,0,46,0,46,0,0,46,0,46,22,0,22,68
03/30/2023,WHP,CA,AWP,WE,Federal Contract Tower,0,0,0,0,0,0,0,67,0,67,0,0,67,0,67,110,0,110,177
03/31/2023,WHP,CA,AWP,WE,Federal Contract Tower,0,0,0,0,0,0,0,164,0,164,0,0,164,0,164,296,0,296,460
04/01/2023,WHP,CA,AWP,WE,Federal Contract Tower,0,0,0,0,0,0,0,222,0,222,0,0,222,0,222,146,0,146,368
04/02/2023,WHP,CA,AWP,WE,Federal Contract Tower,0,0,0,0,0,0,0,151,0,151,0,0,151,0,151,212,0,212,363
04/03/2023,WHP,CA,AWP,WE,Federal Contract Tower,0,0,0,0,0,0,0,28,0,28,0,0,28,0,28,42,0,42,70
04/04/2023,WHP,CA,AWP,WE,Federal Contract Tower,0,0,0,0,0,0,0,62,0,62,0,0,62,0,62,30,0,30,92
04/05/2023,WHP,CA,AWP,WE,Federal Contract Tower,0,0,1,0,1,0,0,141,0,141,0,0,142,0,142,184,0,184,326
04/06/2023,WHP,CA,AWP,WE,Federal Contract Tower,0,0,0,0,0,0,0,140,0,140,0,0,140,0,140,268,0,268,408
04/07/2023,WHP,CA,AWP,WE,Federal Contract Tower,0,0,0,0,0,0,0,134,0,134,0,0,134,0,134,194,0,194,328
04/08/2023,WHP,CA,AWP,WE,Federal Contract Tower,0,0,0,0,0,0,0,170,0,170,0,0,170,0,170,178,0,178,348
04/09/2023,WHP,CA,AWP,WE,Federal Contract Tower,0,0,2,0,2,0,0,109,0,109,0,0,111,0,111,190,0,190,301
04/10/2023,WHP,CA,AWP,WE,Federal Contract Tower,0,0,1,0,1,0,0,89,0,89,0,0,90,0,90,196,0,196,286
04/11/2023,WHP,CA,AWP,WE,Federal Contract Tower,0,0,0,0,0,0,0,97,0,97,0,0,97,0,97,230,0,230,327
04/12/2023,WHP,CA,AWP,WE,Federal Contract Tower,0,0,11,0,11,0,0,12,0,12,0,0,23,0,23,10,0,10,33
04/13/2023,WHP,CA,AWP,WE,Federal Contract Tower,0,0,4,0,4,0,0,35,0,35,0,0,39,0,39,40,0,40,79
04/14/2023,WHP,CA,AWP,WE,Federal Contract Tower,0,0,3,0,3,0,0,94,0,94,0,0,97,0,97,174,0,174,271
04/15/2023,WHP,CA,AWP,WE,Federal Contract Tower,0,0,1,0,1,0,0,163,0,163,0,0,164,0,164,162,0,162,326
04/16/2023,WHP,CA,AWP,WE,Federal Contract Tower,0,0,1,0,1,0,0,145,0,145,0,0,146,0,146,214,0,214,360
04/17/2023,WHP,CA,AWP,WE,Federal Contract Tower,0,0,12,0,12,0,0,42,0,42,0,0,54,0,54,120,0,120,174
04/18/2023,WHP,CA,AWP,WE,Federal Contract Tower,0,0,2,0,2,0,0,89,0,89,0,0,91,0,91,200,0,200,291
04/19/2023,WHP,CA,AWP,WE,Federal Contract Tower,0,0,0,0,0,0,0,83,0,83,0,0,83,0,83,154,0,154,237
04/20/2023,WHP,CA,AWP,WE,Federal Contract Tower,0,0,1,0,1,0,0,112,0,112,0,0,113,0,113,214,0,214,327
04/21/2023,WHP,CA,AWP,WE,Federal Contract Tower,0,0,1,0,1,0,0,157,0,157,0,0,158,0,158,304,0,304,462
04/22/2023,WHP,CA,AWP,WE,Federal Contract Tower,0,0,0,0,0,0,0,172,0,172,0,0,172,0,172,126,0,126,298
04/23/2023,WHP,CA,AWP,WE,Federal Contract Tower,0,0,1,0,1,0,0,168,0,168,0,0,169,0,169,272,0,272,441
04/24/2023,WHP,CA,AWP,WE,Federal Contract Tower,0,0,3,0,3,0,0,69,0,69,0,0,72,0,72,176,0,176,248
04/25/2023,WHP,CA,AWP,WE,Federal Contract Tower,0,0,3,0,3,0,0,121,0,121,0,0,124,0,124,354,0,354,478
04/26/2023,WHP,CA,AWP,WE,Federal Contract Tower,0,0,2,0,2,0,0,142,0,142,0,0,144,0,144,262,0,262,406
04/27/2023,WHP,CA,AWP,WE,Federal Contract Tower,0,0,0,0,0,0,0,108,0,108,0,0,108,0,108,150,0,150,258
04/28/2023,WHP,CA,AWP,WE,Federal Contract Tower,0,0,1,0,1,0,0,113,0,113,0,0,114,0,114,170,0,170,284
04/29/2023,WHP,CA,AWP,WE,Federal Contract Tower,0,0,3,0,3,0,0,102,0,102,0,0,105,0,105,242,0,242,347
04/30/2023,WHP,CA,AWP,WE,Federal Contract Tower,0,0,27,0,27,0,0,93,0,93,0,0,120,0,120,180,0,180,300
05/01/2023,WHP,CA,AWP,WE,Federal Contract Tower,0,0,4,0,4,0,0,46,0,46,0,0,50,0,50,126,0,126,176
05/02/2023,WHP,CA,AWP,WE,Federal Contract Tower,0,0,3,0,3,0,0,91,0,91,0,0,94,0,94,176,0,176,270
05/03/2023,WHP,CA,AWP,WE,Federal Contract Tower,0,0,0,0,0,0,0,91,0,91,0,0,91,0,91,152,0,152,243
05/04/2023,WHP,CA,AWP,WE,Federal Contract Tower,0,0,1,0,1,0,0,45,0,45,0,0,46,0,46,32,0,32,78
05/05/2023,WHP,CA,AWP,WE,Federal Contract Tower,0,0,0,0,0,0,0,129,0,129,0,0,129,0,129,354,0,354,483
05/06/2023,WHP,CA,AWP,WE,Federal Contract Tower,0,0,2,0,2,0,0,124,0,124,0,0,126,0,126,284,0,284,410
05/07/2023,WHP,CA,AWP,WE,Federal Contract Tower,0,0,1,0,1,0,0,151,0,151,0,0,152,0,152,318,0,318,470
05/08/2023,WHP,CA,AWP,WE,Federal Contract Tower,0,0,0,0,0,0,0,103,0,103,0,0,103,0,103,244,0,244,347
05/09/2023,WHP,CA,AWP,WE,Federal Contract Tower,0,0,7,0,7,0,0,79,0,79,0,0,86,0,86,292,0,292,378
05/10/2023,WHP,CA,AWP,WE,Federal Contract Tower,0,0,1,0,1,0,0,126,0,126,0,0,127,0,127,332,0,332,459
05/11/2023,WHP,CA,AWP,WE,Federal Contract Tower,0,0,4,0,4,0,0,123,0,123,0,0,127,0,127,228,0,228,355
05/12/2023,WHP,CA,AWP,WE,Federal Contract Tower,0,0,0,0,0,0,0,107,0,107,0,0,107,0,107,256,0,256,363
05/13/2023,WHP,CA,AWP,WE,Federal Contract Tower,0,0,1,0,1,0,0,136,0,136,0,0,137,0,137,148,0,148,285
05/14/2023,WHP,CA,AWP,WE,Federal Contract Tower,0,0,2,0,2,0,0,76,0,76,0,0,78,0,78,136,0,136,214
05/15/2023,WHP,CA,AWP,WE,Federal Contract Tower,0,0,2,0,2,0,0,80,0,80,0,0,82,0,82,188,0,188,270
05/16/2023,WHP,CA,AWP,WE,Federal Contract Tower,0,0,0,0,0,0,0,125,0,125,0,0,125,0,125,234,0,234,359
05/17/2023,WHP,CA,AWP,WE,Federal Contract Tower,0,0,3,0,3,0,0,131,0,131,0,0,134,0,134,214,0,214,348
05/18/2023,WHP,CA,AWP,WE,Federal Contract Tower,0,0,2,0,2,0,0,102,0,102,0,0,104,0,104,168,0,168,272
05/19/2023,WHP,CA,AWP,WE,Federal Contract Tower,0,0,41,0,41,0,0,7,0,7,0,0,48,0,48,38,0,38,86
05/20/2023,WHP,CA,AWP,WE,Federal Contract Tower,0,0,8,0,8,0,0,112,0,112,0,0,120,0,120,148,0,148,268
05/21/2023,WHP,CA,AWP,WE,Federal Contract Tower,0,0,32,0,32,0,0,101,0,101,0,0,133,0,133,212,0,212,345
05/22/2023,WHP,CA,AWP,WE,Federal Contract Tower,0,0,13,0,13,0,0,51,0,51,0,0,64,0,64,214,0,214,278
05/23/2023,WHP,CA,AWP,WE,Federal Contract Tower,0,0,7,0,7,0,0,25,0,25,0,0,32,0,32,0,0,0,32
05/24/2023,WHP,CA,AWP,WE,Federal Contract Tower,0,0,10,0,10,0,0,48,0,48,0,0,58,0,58,92,0,92,150
05/25/2023,WHP,CA,AWP,WE,Federal Contract Tower,0,0,6,0,6,0,0,99,0,99,0,0,105,0,105,210,0,210,315
05/26/2023,WHP,CA,AWP,WE,Federal Contract Tower,0,0,2,0,2,0,0,127,0,127,0,0,129,0,129,364,0,364,493
05/27/2023,WHP,CA,AWP,WE,Federal Contract Tower,0,0,5,0,5,0,0,187,0,187,0,0,192,0,192,202,0,202,394
05/28/2023,WHP,CA,AWP,WE,Federal Contract Tower,0,0,13,0,13,0,0,36,0,36,0,0,49,0,49,136,0,136,185
05/29/2023,WHP,CA,AWP,WE,Federal Contract Tower,0,0,9,0,9,0,0,64,0,64,0,0,73,0,73,190,0,190,263
05/30/2023,WHP,CA,AWP,WE,Federal Contract Tower,0,0,6,0,6,0,0,116,0,116,0,0,122,0,122,356,0,356,478
05/31/2023,WHP,CA,AWP,WE,Federal Contract Tower,0,0,5,0,5,0,0,80,0,80,0,0,85,0,85,366,0,366,451
06/01/2023,WHP,CA,AWP,WE,Federal Contract Tower,0,0,4,0,4,0,0,100,0,100,0,0,104,0,104,254,0,254,358
06/02/2023,WHP,CA,AWP,WE,Federal Contract Tower,0,0,2,0,2,0,0,112,0,112,0,0,114,0,114,254,0,254,368
06/03/2023,WHP,CA,AWP,WE,Federal Contract Tower,0,0,4,0,4,0,0,176,0,176,0,0,180,0,180,274,0,274,454
06/04/2023,WHP,CA,AWP,WE,Federal Contract Tower,0,0,6,0,6,0,0,112,0,112,0,0,118,0,118,274,0,274,392
06/05/2023,WHP,CA,AWP,WE,Federal Contract Tower,0,0,9,0,9,0,0,11,0,11,0,0,20,0,20,4,0,4,24
06/06/2023,WHP,CA,AWP,WE,Federal Contract Tower,0,0,6,0,6,0,0,134,0,134,0,0,140,0,140,370,0,370,510
06/07/2023,WHP,CA,AWP,WE,Federal Contract Tower,0,0,3,0,3,0,0,92,0,92,0,0,95,0,95,294,0,294,389
06/09/2023,WHP,CA,AWP,WE,Federal Contract Tower,0,0,15,0,15,0,0,40,0,40,0,0,55,0,55,226,0,226,281
06/10/2023,WHP,CA,AWP,WE,Federal Contract Tower,0,0,4,0,4,0,0,33,0,33,0,0,37,0,37,320,0,320,357
06/11/2023,WHP,CA,AWP,WE,Federal Contract Tower,0,0,9,0,9,0,0,49,0,49,0,0,58,0,58,332,0,332,390
06/12/2023,WHP,CA,AWP,WE,Federal Contract Tower,0,0,5,0,5,0,0,81,0,81,0,0,86,0,86,320,0,320,406
06/13/2023,WHP,CA,AWP,WE,Federal Contract Tower,0,0,6,0,6,0,0,114,0,114,0,0,120,0,120,298,0,298,418
06/14/2023,WHP,CA,AWP,WE,Federal Contract Tower,0,0,6,0,6,0,0,77,0,77,0,0,83,0,83,178,0,178,261
06/15/2023,WHP,CA,AWP,WE,Federal Contract Tower,0,0,7,0,7,0,0,45,0,45,0,0,52,0,52,76,0,76,128
06/16/2023,WHP,CA,AWP,WE,Federal Contract Tower,0,0,5,0,5,0,0,66,0,66,0,0,71,0,71,76,0,76,147
06/17/2023,WHP,CA,AWP,WE,Federal Contract Tower,0,0,1,0,1,0,0,162,0,162,0,0,163,0,163,168,0,168,331
06/18/2023,WHP,CA,AWP,WE,Federal Contract Tower,0,0,5,0,5,0,0,51,0,51,0,0,56,0,56,160,0,160,216
06/19/2023,WHP,CA,AWP,WE,Federal Contract Tower,0,0,6,0,6,0,0,63,0,63,0,0,69,0,69,228,0,228,297
06/20/2023,WHP,CA,AWP,WE,Federal Contract Tower,0,0,1,0,1,0,0,136,0,136,0,0,137,0,137,324,0,324,461
06/21/2023,WHP,CA,AWP,WE,Federal Contract Tower,0,0,2,0,2,0,0,146,0,146,0,0,148,0,148,300,0,300,448
06/22/2023,WHP,CA,AWP,WE,Federal Contract Tower,0,0,1,0,1,0,0,107,0,107,0,0,108,0,108,210,0,210,318
06/23/2023,WHP,CA,AWP,WE,Federal Contract Tower,0,0,2,0,2,0,0,114,0,114,0,0,116,0,116,180,0,180,296
06/24/2023,WHP,CA,AWP,WE,Federal Contract Tower,0,0,4,0,4,0,0,207,0,207,0,0,211,0,211,108,0,108,319
06/25/2023,WHP,CA,AWP,WE,Federal Contract Tower,0,0,5,0,5,0,0,132,0,132,0,0,137,0,137,148,0,148,285
06/26/2023,WHP,CA,AWP,WE,Federal Contract Tower,0,0,0,0,0,0,0,117,0,117,0,0,117,0,117,198,0,198,315
06/27/2023,WHP,CA,AWP,WE,Federal Contract Tower,0,0,0,0,0,0,0,117,0,117,0,0,117,0,117,272,0,272,389
06/28/2023,WHP,CA,AWP,WE,Federal Contract Tower,0,0,2,0,2,0,0,150,0,150,0,0,152,0,152,258,0,258,410
06/29/2023,WHP,CA,AWP,WE,Federal Contract Tower,0,0,2,0,2,0,0,112,0,112,0,0,114,0,114,208,0,208,322
06/30/2023,WHP,CA,AWP,WE,Federal Contract Tower,0,0,1,0,1,0,0,136,0,136,0,0,137,0,137,266,0,266,403
07/01/2023,WHP,CA,AWP,WE,Federal Contract Tower,0,0,4,0,4,0,0,102,0,102,0,0,106,0,106,150,0,150,256
07/02/2023,WHP,CA,AWP,WE,Federal Contract Tower,0,0,1,0,1,0,0,110,0,110,0,0,111,0,111,214,0,214,325
07/03/2023,WHP,CA,AWP,WE,Federal Contract Tower,0,0,1,0,1,0,0,105,0,105,0,0,106,0,106,263,0,263,369
07/04/2023,WHP,CA,AWP,WE,Federal Contract Tower,0,0,0,0,0,0,0,102,0,102,0,0,102,0,102,166,0,166,268
07/05/2023,WHP,CA,AWP,WE,Federal Contract Tower,0,0,4,0,4,0,0,102,0,102,0,0,106,0,106,184,0,184,290
07/06/2023,WHP,CA,AWP,WE,Federal Contract Tower,0,0,0,0,0,0,0,102,0,102,0,0,102,0,102,172,0,172,274
07/07/2023,WHP,CA,AWP,WE,Federal Contract Tower,0,0,3,0,3,0,0,109,0,109,0,0,112,0,112,160,0,160,272
07/08/2023,WHP,CA,AWP,WE,Federal Contract Tower,0,0,4,0,4,0,0,119,0,119,0,0,123,0,123,140,0,140,263
07/09/2023,WHP,CA,AWP,WE,Federal Contract Tower,0,0,2,0,2,0,0,110,0,110,0,0,112,0,112,166,0,166,278
07/10/2023,WHP,CA,AWP,WE,Federal Contract Tower,0,0,0,0,0,0,0,115,0,115,0,0,115,0,115,154,0,154,269
07/11/2023,WHP,CA,AWP,WE,Federal Contract Tower,0,0,0,0,0,0,0,114,0,114,0,0,114,0,114,266,0,266,380
07/12/2023,WHP,CA,AWP,WE,Federal Contract Tower,0,0,1,0,1,0,0,130,0,130,0,0,131,0,131,196,0,196,327
07/13/2023,WHP,CA,AWP,WE,Federal Contract Tower,0,0,3,0,3,0,0,136,0,136,0,0,139,0,139,234,0,234,373
07/14/2023,WHP,CA,AWP,WE,Federal Contract Tower,0,0,0,0,0,0,0,116,0,116,0,0,116,0,116,176,0,176,292
07/15/2023,WHP,CA,AWP,WE,Federal Contract Tower,0,0,0,0,0,0,0,131,0,131,0,0,131,0,131,126,0,126,257
07/16/2023,WHP,CA,AWP,WE,Federal Contract Tower,0,0,0,0,0,0,0,102,0,102,0,0,102,0,102,176,0,176,278
07/17/2023,WHP,CA,AWP,WE,Federal Contract Tower,0,0,0,0,0,0,0,84,0,84,0,0,84,0,84,70,0,70,154
07/18/2023,WHP,CA,AWP,WE,Federal Contract Tower,0,0,0,0,0,0,0,131,0,131,0,0,131,0,131,306,0,306,437
07/19/2023,WHP,CA,AWP,WE,Federal Contract Tower,0,0,3,0,3,0,0,137,0,137,0,0,140,0,140,310,0,310,450
07/20/2023,WHP,CA,AWP,WE,Federal Contract Tower,0,0,1,0,1,0,0,139,0,139,0,0,140,0,140,172,0,172,312
07/21/2023,WHP,CA,AWP,WE,Federal Contract Tower,0,0,0,0,0,0,0,140,0,140,0,0,140,0,140,182,0,182,322
07/22/2023,WHP,CA,AWP,WE,Federal Contract Tower,0,0,0,0,0,0,0,197,0,197,0,0,197,0,197,104,0,104,301
07/23/2023,WHP,CA,AWP,WE,Federal Contract Tower,0,0,0,0,0,0,0,88,0,88,0,0,88,0,88,158,0,158,246
07/24/2023,WHP,CA,AWP,WE,Federal Contract Tower,0,0,1,0,1,0,0,107,0,107,0,0,108,0,108,258,0,258,366
07/25/2023,WHP,CA,AWP,WE,Federal Contract Tower,0,0,0,0,0,0,0,104,0,104,0,0,104,0,104,214,0,214,318
07/26/2023,WHP,CA,AWP,WE,Federal Contract Tower,0,0,1,0,1,0,0,131,0,131,0,0,132,0,132,232,0,232,364
07/27/2023,WHP,CA,AWP,WE,Federal Contract Tower,0,0,3,0,3,0,0,116,0,116,0,0,119,0,119,140,0,140,259
07/28/2023,WHP,CA,AWP,WE,Federal Contract Tower,0,0,0,0,0,0,0,86,0,86,0,0,86,0,86,174,0,174,260
07/29/2023,WHP,CA,AWP,WE,Federal Contract Tower,0,0,0,0,0,0,0,105,0,105,0,0,105,0,105,114,0,114,219
07/30/2023,WHP,CA,AWP,WE,Federal Contract Tower,0,0,1,0,1,0,0,92,0,92,0,0,93,0,93,170,0,170,263
07/31/2023,WHP,CA,AWP,WE,Federal Contract Tower,0,0,0,0,0,0,0,67,0,67,0,0,67,0,67,248,0,248,315
08/01/2023,WHP,CA,AWP,WE,Federal Contract Tower,0,0,0,0,0,0,0,118,0,118,0,0,118,0,118,328,0,328,446
08/02/2023,WHP,CA,AWP,WE,Federal Contract Tower,0,0,1,0,1,0,0,125,0,125,0,0,126,0,126,288,0,288,414
08/03/2023,WHP,CA,AWP,WE,Federal Contract Tower,0,0,2,0,2,0,0,141,0,141,0,0,143,0,143,168,0,168,311
08/05/2023,WHP,CA,AWP,WE,Federal Contract Tower,0,0,0,0,0,0,0,112,0,112,0,0,112,0,112,146,0,146,258
08/06/2023,WHP,CA,AWP,WE,Federal Contract Tower,0,0,1,0,1,0,0,120,0,120,0,0,121,0,121,174,0,174,295
08/07/2023,WHP,CA,AWP,WE,Federal Contract Tower,0,0,0,0,0,0,0,89,0,89,0,0,89,0,89,178,0,178,267
08/08/2023,WHP,CA,AWP,WE,Federal Contract Tower,0,0,0,0,0,0,0,133,0,133,0,0,133,0,133,250,0,250,383
08/09/2023,WHP,CA,AWP,WE,Federal Contract Tower,0,0,2,0,2,0,0,119,0,119,0,0,121,0,121,248,0,248,369
08/10/2023,WHP,CA,AWP,WE,Federal Contract Tower,0,0,3,0,3,0,0,62,0,62,0,0,65,0,65,60,0,60,125
08/11/2023,WHP,CA,AWP,WE,Federal Contract Tower,0,0,4,0,4,0,0,85,0,85,0,0,89,0,89,176,0,176,265
08/12/2023,WHP,CA,AWP,WE,Federal Contract Tower,0,0,0,0,0,0,0,114,0,114,0,0,114,0,114,228,0,228,342
08/13/2023,WHP,CA,AWP,WE,Federal Contract Tower,0,0,3,0,3,0,0,175,0,175,0,0,178,0,178,244,0,244,422
08/14/2023,WHP,CA,AWP,WE,Federal Contract Tower,0,0,3,0,3,0,0,92,0,92,0,0,95,0,95,310,0,310,405
08/15/2023,WHP,CA,AWP,WE,Federal Contract Tower,0,0,0,0,0,0,0,114,0,114,0,0,114,0,114,230,0,230,344
08/16/2023,WHP,CA,AWP,WE,Federal Contract Tower,0,0,4,0,4,0,0,93,0,93,0,0,97,0,97,162,0,162,259
08/17/2023,WHP,CA,AWP,WE,Federal Contract Tower,0,0,0,0,0,0,0,61,0,61,0,0,61,0,61,80,0,80,141
08/18/2023,WHP,CA,AWP,WE,Federal Contract Tower,0,0,3,0,3,0,0,127,0,127,0,0,130,0,130,238,0,238,368
08/19/2023,WHP,CA,AWP,WE,Federal Contract Tower,0,0,2,0,2,0,0,108,0,108,0,0,110,0,110,214,0,214,324
08/20/2023,WHP,CA,AWP,WE,Federal Contract Tower,0,0,4,0,4,0,0,0,0,0,0,0,4,0,4,0,0,0,4
08/21/2023,WHP,CA,AWP,WE,Federal Contract Tower,0,0,1,0,1,0,0,52,0,52,0,0,53,0,53,120,0,120,173
08/22/2023,WHP,CA,AWP,WE,Federal Contract Tower,0,0,5,0,5,0,0,134,0,134,0,0,139,0,139,294,0,294,433
08/23/2023,WHP,CA,AWP,WE,Federal Contract Tower,0,0,0,0,0,0,0,134,0,134,0,0,134,0,134,334,0,334,468
08/24/2023,WHP,CA,AWP,WE,Federal Contract Tower,0,0,2,0,2,0,0,87,0,87,0,0,89,0,89,214,0,214,303
08/25/2023,WHP,CA,AWP,WE,Federal Contract Tower,0,0,1,0,1,0,0,94,0,94,0,0,95,0,95,316,0,316,411
08/26/2023,WHP,CA,AWP,WE,Federal Contract Tower,0,0,2,0,2,0,0,212,0,212,0,0,214,0,214,58,0,58,272
08/27/2023,WHP,CA,AWP,WE,Federal Contract Tower,0,0,5,0,5,0,0,143,0,143,0,0,148,0,148,166,0,166,314
08/28/2023,WHP,CA,AWP,WE,Federal Contract Tower,0,0,1,0,1,0,0,77,0,77,0,0,78,0,78,160,0,160,238
08/29/2023,WHP,CA,AWP,WE,Federal Contract Tower,0,0,0,0,0,0,0,66,0,66,0,0,66,0,66,138,0,138,204
08/30/2023,WHP,CA,AWP,WE,Federal Contract Tower,0,0,0,0,0,0,0,94,0,94,0,0,94,0,94,60,0,60,154
08/31/2023,WHP,CA,AWP,WE,Federal Contract Tower,0,0,4,0,4,0,0,142,0,142,0,0,146,0,146,214,0,214,360
01/01/2020,WHP,CA,AWP,WE,Federal Contract Tower,0,0,0,0,0,0,0,93,0,93,0,0,93,0,93,64,0,64,157
01/02/2020,WHP,CA,AWP,WE,Federal Contract Tower,0,0,0,0,0,0,0,104,0,104,0,0,104,0,104,146,0,146,250
01/03/2020,WHP,CA,AWP,WE,Federal Contract Tower,0,0,0,0,0,0,0,122,0,122,0,0,122,0,122,192,0,192,314
01/04/2020,WHP,CA,AWP,WE,Federal Contract Tower,0,0,3,0,3,0,0,132,0,132,0,0,135,0,135,172,0,172,307
01/05/2020,WHP,CA,AWP,WE,Federal Contract Tower,0,0,2,0,2,0,0,72,0,72,0,0,74,0,74,112,0,112,186
01/06/2020,WHP,CA,AWP,WE,Federal Contract Tower,0,0,0,0,0,0,0,63,0,63,0,0,63,0,63,172,0,172,235
01/07/2020,WHP,CA,AWP,WE,Federal Contract Tower,0,0,0,0,0,0,0,98,0,98,0,0,98,0,98,110,0,110,208
01/08/2020,WHP,CA,AWP,WE,Federal Contract Tower,0,0,0,0,0,0,0,101,0,101,0,0,101,0,101,196,0,196,297
01/09/2020,WHP,CA,AWP,WE,Federal Contract Tower,0,0,0,0,0,0,0,74,0,74,0,0,74,0,74,94,0,94,168
01/10/2020,WHP,CA,AWP,WE,Federal Contract Tower,0,0,1,0,1,0,0,175,0,175,0,0,176,0,176,248,0,248,424
01/11/2020,WHP,CA,AWP,WE,Federal Contract Tower,0,0,0,0,0,0,0,137,0,137,0,0,137,0,137,236,0,236,373
01/12/2020,WHP,CA,AWP,WE,Federal Contract Tower,0,0,2,0,2,0,0,171,0,171,0,0,173,0,173,222,0,222,395
01/13/2020,WHP,CA,AWP,WE,Federal Contract Tower,0,0,2,0,2,0,0,69,0,69,0,0,71,0,71,98,0,98,169
01/14/2020,WHP,CA,AWP,WE,Federal Contract Tower,0,0,0,0,0,0,0,97,0,97,0,0,97,0,97,134,0,134,231
01/15/2020,WHP,CA,AWP,WE,Federal Contract Tower,0,0,0,0,0,0,0,156,0,156,0,0,156,0,156,186,0,186,342
01/16/2020,WHP,CA,AWP,WE,Federal Contract Tower,0,0,3,0,3,0,0,36,0,36,0,0,39,0,39,94,0,94,133
01/17/2020,WHP,CA,AWP,WE,Federal Contract Tower,0,0,1,0,1,0,0,147,0,147,0,0,148,0,148,220,0,220,368
01/18/2020,WHP,CA,AWP,WE,Federal Contract Tower,0,0,1,0,1,0,0,152,0,152,0,0,153,0,153,138,0,138,291
01/19/2020,WHP,CA,AWP,WE,Federal Contract Tower,0,0,1,0,1,0,0,113,0,113,0,0,114,0,114,216,0,216,330
01/20/2020,WHP,CA,AWP,WE,Federal Contract Tower,0,0,0,0,0,0,0,81,0,81,0,0,81,0,81,200,0,200,281
01/21/2020,WHP,CA,AWP,WE,Federal Contract Tower,0,0,6,0,6,0,0,64,0,64,0,0,70,0,70,134,0,134,204
01/22/2020,WHP,CA,AWP,WE,Federal Contract Tower,0,0,0,0,0,0,0,106,0,106,0,0,106,0,106,174,0,174,280
01/23/2020,WHP,CA,AWP,WE,Federal Contract Tower,0,0,1,0,1,0,0,126,0,126,0,0,127,0,127,76,0,76,203
01/24/2020,WHP,CA,AWP,WE,Federal Contract Tower,0,0,2,0,2,0,0,140,0,140,0,0,142,0,142,126,0,126,268
01/25/2020,WHP,CA,AWP,WE,Federal Contract Tower,0,0,0,0,0,0,0,205,0,205,0,0,205,0,205,202,0,202,407
01/26/2020,WHP,CA,AWP,WE,Federal Contract Tower,0,0,10,0,10,0,0,36,0,36,0,0,46,0,46,60,0,60,106
01/27/2020,WHP,CA,AWP,WE,Federal Contract Tower,0,0,2,0,2,0,0,46,0,46,0,0,48,0,48,36,0,36,84
01/28/2020,WHP,CA,AWP,WE,Federal Contract Tower,0,0,1,0,1,0,0,68,0,68,0,0,69,0,69,54,0,54,123
01/29/2020,WHP,CA,AWP,WE,Federal Contract Tower,0,0,0,0,0,0,0,33,0,33,0,0,33,0,33,4,0,4,37
01/30/2020,WHP,CA,AWP,WE,Federal Contract Tower,0,0,0,0,0,0,0,119,0,119,0,0,119,0,119,132,0,132,251
01/31/2020,WHP,CA,AWP,WE,Federal Contract Tower,0,0,0,0,0,0,0,111,0,111,0,0,111,0,111,68,0,68,179
02/01/2020,WHP,CA,AWP,WE,Federal Contract Tower,0,0,2,0,2,0,0,170,0,170,0,0,172,0,172,156,0,156,328
02/02/2020,WHP,CA,AWP,WE,Federal Contract Tower,0,0,1,0,1,0,0,103,0,103,0,0,104,0,104,108,0,108,212
02/03/2020,WHP,CA,AWP,WE,Federal Contract Tower,0,0,0,0,0,0,0,17,0,17,0,0,17,0,17,2,0,2,19
02/04/2020,WHP,CA,AWP,WE,Federal Contract Tower,0,0,0,0,0,0,0,19,0,19,0,0,19,0,19,10,0,10,29
02/05/2020,WHP,CA,AWP,WE,Federal Contract Tower,0,0,2,0,2,0,0,114,0,114,0,0,116,0,116,118,0,118,234
02/06/2020,WHP,CA,AWP,WE,Federal Contract Tower,0,0,0,0,0,0,0,145,0,145,0,0,145,0,145,138,0,138,283
02/07/2020,WHP,CA,AWP,WE,Federal Contract Tower,0,0,1,0,1,0,0,189,0,189,0,0,190,0,190,264,0,264,454
02/08/2020,WHP,CA,AWP,WE,Federal Contract Tower,0,0,0,0,0,0,0,220,0,220,0,0,220,0,220,274,0,274,494
02/09/2020,WHP,CA,AWP,WE,Federal Contract Tower,0,0,5,0,5,0,0,23,0,23,0,0,28,0,28,60,0,60,88
02/10/2020,WHP,CA,AWP,WE,Federal Contract Tower,0,0,0,0,0,0,0,29,0,29,0,0,29,0,29,0,0,0,29
02/11/2020,WHP,CA,AWP,WE,Federal Contract Tower,0,0,0,0,0,0,0,35,0,35,0,0,35,0,35,26,0,26,61
02/12/2020,WHP,CA,AWP,WE,Federal Contract Tower,0,0,0,0,0,0,0,142,0,142,0,0,142,0,142,184,0,184,326
02/13/2020,WHP,CA,AWP,WE,Federal Contract Tower,0,0,1,0,1,0,0,139,0,139,0,0,140,0,140,156,0,156,296
02/14/2020,WHP,CA,AWP,WE,Federal Contract Tower,0,0,0,0,0,0,0,178,0,178,0,0,178,0,178,224,0,224,402
02/15/2020,WHP,CA,AWP,WE,Federal Contract Tower,0,0,4,0,4,0,0,153,0,153,0,0,157,0,157,156,0,156,313
02/16/2020,WHP,CA,AWP,WE,Federal Contract Tower,0,0,1,0,1,0,0,127,0,127,0,0,128,0,128,160,0,160,288
02/17/2020,WHP,CA,AWP,WE,Federal Contract Tower,0,0,0,0,0,0,0,141,0,141,0,0,141,0,141,136,0,136,277
02/18/2020,WHP,CA,AWP,WE,Federal Contract Tower,0,0,2,0,2,0,0,61,0,61,0,0,63,0,63,96,0,96,159
02/19/2020,WHP,CA,AWP,WE,Federal Contract Tower,0,0,1,0,1,0,0,100,0,100,0,0,101,0,101,106,0,106,207
02/20/2020,WHP,CA,AWP,WE,Federal Contract Tower,0,0,0,0,0,0,0,130,0,130,0,0,130,0,130,104,0,104,234
02/21/2020,WHP,CA,AWP,WE,Federal Contract Tower,0,0,0,0,0,0,0,142,0,142,0,0,142,0,142,226,0,226,368
02/22/2020,WHP,CA,AWP,WE,Federal Contract Tower,0,0,2,0,2,0,0,62,0,62,0,0,64,0,64,166,0,166,230
02/23/2020,WHP,CA,AWP,WE,Federal Contract Tower,0,0,0,0,0,0,0,120,0,120,0,0,120,0,120,146,0,146,266
02/24/2020,WHP,CA,AWP,WE,Federal Contract Tower,0,0,2,0,2,0,0,95,0,95,0,0,97,0,97,160,0,160,257
02/25/2020,WHP,CA,AWP,WE,Federal Contract Tower,0,0,0,0,0,0,0,49,0,49,0,0,49,0,49,42,0,42,91
02/26/2020,WHP,CA,AWP,WE,Federal Contract Tower,0,0,0,0,0,0,0,81,0,81,0,0,81,0,81,42,0,42,123
02/27/2020,WHP,CA,AWP,WE,Federal Contract Tower,0,0,0,0,0,0,0,129,0,129,0,0,129,0,129,142,0,142,271
02/28/2020,WHP,CA,AWP,WE,Federal Contract Tower,0,0,2,0,2,0,0,147,0,147,0,0,149,0,149,116,0,116,265
02/29/2020,WHP,CA,AWP,WE,Federal Contract Tower,0,0,3,0,3,0,0,162,0,162,0,0,165,0,165,180,0,180,345
03/01/2020,WHP,CA,AWP,WE,Federal Contract Tower,0,0,1,0,1,0,0,37,0,37,0,0,38,0,38,94,0,94,132
03/02/2020,WHP,CA,AWP,WE,Federal Contract Tower,0,0,0,0,0,0,0,29,0,29,0,0,29,0,29,2,0,2,31
03/03/2020,WHP,CA,AWP,WE,Federal Contract Tower,0,0,1,0,1,0,0,86,0,86,0,0,87,0,87,104,0,104,191
03/04/2020,WHP,CA,AWP,WE,Federal Contract Tower,0,0,0,0,0,0,0,106,0,106,0,0,106,0,106,160,0,160,266
03/05/2020,WHP,CA,AWP,WE,Federal Contract Tower,0,0,0,0,0,0,0,153,0,153,0,0,153,0,153,274,0,274,427
03/06/2020,WHP,CA,AWP,WE,Federal Contract Tower,0,0,0,0,0,0,0,162,0,162,0,0,162,0,162,190,0,190,352
03/07/2020,WHP,CA,AWP,WE,Federal Contract Tower,0,0,3,0,3,0,0,134,0,134,0,0,137,0,137,262,0,262,399
03/08/2020,WHP,CA,AWP,WE,Federal Contract Tower,0,0,3,0,3,0,0,137,0,137,0,0,140,0,140,290,0,290,430
03/09/2020,WHP,CA,AWP,WE,Federal Contract Tower,0,0,0,0,0,0,0,81,0,81,0,0,81,0,81,108,0,108,189
03/10/2020,WHP,CA,AWP,WE,Federal Contract Tower,0,0,1,0,1,0,0,4,0,4,0,0,5,0,5,18,0,18,23
03/11/2020,WHP,CA,AWP,WE,Federal Contract Tower,0,0,6,0,6,0,0,53,0,53,0,0,59,0,59,76,0,76,135
03/12/2020,WHP,CA,AWP,WE,Federal Contract Tower,0,0,2,0,2,0,0,74,0,74,0,0,76,0,76,52,0,52,128
03/13/2020,WHP,CA,AWP,WE,Federal Contract Tower,0,0,1,0,1,0,0,17,0,17,0,0,18,0,18,0,0,0,18
03/14/2020,WHP,CA,AWP,WE,Federal Contract Tower,0,0,10,0,10,0,0,5,0,5,0,0,15,0,15,0,0,0,15
03/15/2020,WHP,CA,AWP,WE,Federal Contract Tower,0,0,0,0,0,0,0,61,0,61,0,0,61,0,61,128,0,128,189
03/16/2020,WHP,CA,AWP,WE,Federal Contract Tower,0,0,0,0,0,0,0,31,0,31,0,0,31,0,31,26,0,26,57
03/17/2020,WHP,CA,AWP,WE,Federal Contract Tower,0,0,0,0,0,0,0,19,0,19,0,0,19,0,19,86,0,86,105
03/18/2020,WHP,CA,AWP,WE,Federal Contract Tower,0,0,0,0,0,0,0,91,0,91,0,0,91,0,91,122,0,122,213
03/19/2020,WHP,CA,AWP,WE,Federal Contract Tower,0,0,0,0,0,0,0,42,0,42,0,0,42,0,42,48,0,48,90
03/20/2020,WHP,CA,AWP,WE,Federal Contract Tower,0,0,2,0,2,0,0,46,0,46,0,0,48,0,48,26,0,26,74
03/21/2020,WHP,CA,AWP,WE,Federal Contract Tower,0,0,0,0,0,0,0,95,0,95,0,0,95,0,95,140,0,140,235
03/22/2020,WHP,CA,AWP,WE,Federal Contract Tower,0,0,4,0,4,0,0,56,0,56,0,0,60,0,60,132,0,132,192
03/23/2020,WHP,CA,AWP,WE,Federal Contract Tower,0,0,0,0,0,0,0,21,0,21,0,0,21,0,21,0,0,0,21
03/24/2020,WHP,CA,AWP,WE,Federal Contract Tower,0,0,2,0,2,0,0,32,0,32,0,0,34,0,34,50,0,50,84
03/25/2020,WHP,CA,AWP,WE,Federal Contract Tower,0,0,1,0,1,0,0,36,0,36,0,0,37,0,37,18,0,18,55
03/26/2020,WHP,CA,AWP,WE,Federal Contract Tower,0,0,0,0,0,0,0,82,0,82,0,0,82,0,82,54,0,54,136
03/28/2020,WHP,CA,AWP,WE,Federal Contract Tower,0,0,1,0,1,0,0,113,0,113,0,0,114,0,114,72,0,72,186
03/29/2020,WHP,CA,AWP,WE,Federal Contract Tower,0,0,0,0,0,0,0,101,0,101,0,0,101,0,101,86,0,86,187
03/30/2020,WHP,CA,AWP,WE,Federal Contract Tower,0,0,0,0,0,0,0,130,0,130,0,0,130,0,130,48,0,48,178
03/31/2020,WHP,CA,AWP,WE,Federal Contract Tower,0,0,0,0,0,0,0,100,0,100,0,0,100,0,100,92,0,92,192
04/01/2020,WHP,CA,AWP,WE,Federal Contract Tower,0,0,0,0,0,0,0,109,0,109,0,0,109,0,109,116,0,116,225
04/02/2020,WHP,CA,AWP,WE,Federal Contract Tower,0,0,0,0,0,0,0,67,0,67,0,0,67,0,67,74,0,74,141
04/03/2020,WHP,CA,AWP,WE,Federal Contract Tower,0,0,0,0,0,0,0,112,0,112,0,0,112,0,112,128,0,128,240
04/04/2020,WHP,CA,AWP,WE,Federal Contract Tower,0,0,2,0,2,0,0,76,0,76,0,0,78,0,78,76,0,76,154
04/05/2020,WHP,CA,AWP,WE,Federal Contract Tower,0,0,2,0,2,0,0,0,0,0,0,0,2,0,2,28,0,28,30
04/06/2020,WHP,CA,AWP,WE,Federal Contract Tower,0,0,1,0,1,0,0,14,0,14,0,0,15,0,15,8,0,8,23
04/07/2020,WHP,CA,AWP,WE,Federal Contract Tower,0,0,2,0,2,0,0,18,0,18,0,0,20,0,20,34,0,34,54
04/08/2020,WHP,CA,AWP,WE,Federal Contract Tower,0,0,0,0,0,0,0,21,0,21,0,0,21,0,21,60,0,60,81
04/09/2020,WHP,CA,AWP,WE,Federal Contract Tower,0,0,2,0,2,0,0,16,0,16,0,0,18,0,18,0,0,0,18
04/10/2020,WHP,CA,AWP,WE,Federal Contract Tower,0,0,4,0,4,0,0,53,0,53,0,0,57,0,57,94,0,94,151
04/11/2020,WHP,CA,AWP,WE,Federal Contract Tower,0,0,0,0,0,0,0,120,0,120,0,0,120,0,120,140,0,140,260
04/12/2020,WHP,CA,AWP,WE,Federal Contract Tower,0,0,6,0,6,0,0,13,0,13,0,0,19,0,19,60,0,60,79
04/13/2020,WHP,CA,AWP,WE,Federal Contract Tower,0,0,1,0,1,0,0,54,0,54,0,0,55,0,55,84,0,84,139
04/14/2020,WHP,CA,AWP,WE,Federal Contract Tower,0,0,0,0,0,0,0,70,0,70,0,0,70,0,70,72,0,72,142
04/15/2020,WHP,CA,AWP,WE,Federal Contract Tower,0,0,1,0,1,0,0,132,0,132,0,0,133,0,133,150,0,150,283
04/16/2020,WHP,CA,AWP,WE,Federal Contract Tower,0,0,2,0,2,0,0,118,0,118,0,0,120,0,120,126,0,126,246
04/18/2020,WHP,CA,AWP,WE,Federal Contract Tower,0,0,0,0,0,0,0,40,0,40,0,0,40,0,40,64,0,64,104
04/19/2020,WHP,CA,AWP,WE,Federal Contract Tower,0,0,4,0,4,0,0,56,0,56,0,0,60,0,60,98,0,98,158
04/20/2020,WHP,CA,AWP,WE,Federal Contract Tower,0,0,4,0,4,0,0,71,0,71,0,0,75,0,75,130,0,130,205
04/21/2020,WHP,CA,AWP,WE,Federal Contract Tower,0,0,3,0,3,0,0,90,0,90,0,0,93,0,93,122,0,122,215
04/22/2020,WHP,CA,AWP,WE,Federal Contract Tower,0,0,0,0,0,0,0,122,0,122,0,0,122,0,122,102,0,102,224
04/23/2020,WHP,CA,AWP,WE,Federal Contract Tower,0,0,0,0,0,0,0,71,0,71,0,0,71,0,71,102,0,102,173
04/24/2020,WHP,CA,AWP,WE,Federal Contract Tower,0,0,1,0,1,0,0,73,0,73,0,0,74,0,74,130,0,130,204
04/25/2020,WHP,CA,AWP,WE,Federal Contract Tower,0,0,0,0,0,0,0,127,0,127,0,0,127,0,127,172,0,172,299
04/26/2020,WHP,CA,AWP,WE,Federal Contract Tower,0,0,0,0,0,0,0,99,0,99,0,0,99,0,99,114,0,114,213
04/27/2020,WHP,CA,AWP,WE,Federal Contract Tower,0,0,0,0,0,0,0,76,0,76,0,0,76,0,76,88,0,88,164
04/28/2020,WHP,CA,AWP,WE,Federal Contract Tower,0,0,0,0,0,0,0,107,0,107,0,0,107,0,107,204,0,204,311
04/29/2020,WHP,CA,AWP,WE,Federal Contract Tower,0,0,1,0,1,0,0,84,0,84,0,0,85,0,85,162,0,162,247
04/30/2020,WHP,CA,AWP,WE,Federal Contract Tower,0,0,0,0,0,0,0,108,0,108,0,0,108,0,108,168,0,168,276
05/01/2020,WHP,CA,AWP,WE,Federal Contract Tower,0,0,0,0,0,0,0,68,0,68,0,0,68,0,68,108,0,108,176
05/02/2020,WHP,CA,AWP,WE,Federal Contract Tower,0,0,0,0,0,0,0,68,0,68,0,0,68,0,68,118,0,118,186
05/03/2020,WHP,CA,AWP,WE,Federal Contract Tower,0,0,0,0,0,0,0,130,0,130,0,0,130,0,130,98,0,98,228
05/04/2020,WHP,CA,AWP,WE,Federal Contract Tower,0,0,0,0,0,0,0,107,0,107,0,0,107,0,107,137,0,137,244
05/05/2020,WHP,CA,AWP,WE,Federal Contract Tower,0,0,0,0,0,0,0,118,0,118,0,0,118,0,118,166,0,166,284
05/06/2020,WHP,CA,AWP,WE,Federal Contract Tower,0,0,0,0,0,0,0,124,0,124,0,0,124,0,124,172,0,172,296
05/07/2020,WHP,CA,AWP,WE,Federal Contract Tower,0,0,1,0,1,0,0,132,0,132,0,0,133,0,133,218,0,218,351
05/08/2020,WHP,CA,AWP,WE,Federal Contract Tower,0,0,0,0,0,0,0,149,0,149,0,0,149,0,149,0,214,214,363
05/09/2020,WHP,CA,AWP,WE,Federal Contract Tower,0,0,0,0,0,0,0,99,0,99,0,0,99,0,99,150,0,150,249
05/10/2020,WHP,CA,AWP,WE,Federal Contract Tower,0,0,3,0,3,0,0,79,0,79,0,0,82,0,82,68,0,68,150
05/11/2020,WHP,CA,AWP,WE,Federal Contract Tower,0,0,2,0,2,0,0,90,0,90,0,0,92,0,92,34,0,34,126
05/12/2020,WHP,CA,AWP,WE,Federal Contract Tower,0,0,0,0,0,0,0,81,0,81,0,0,81,0,81,150,0,150,231
05/14/2020,WHP,CA,AWP,WE,Federal Contract Tower,0,0,2,0,2,0,0,99,0,99,0,0,101,0,101,154,0,154,255
05/15/2020,WHP,CA,AWP,WE,Federal Contract Tower,0,0,0,0,0,0,0,131,0,131,0,0,131,0,131,178,0,178,309
05/16/2020,WHP,CA,AWP,WE,Federal Contract Tower,0,0,0,0,0,0,0,137,0,137,0,0,137,0,137,274,0,274,411
05/17/2020,WHP,CA,AWP,WE,Federal Contract Tower,0,0,1,0,1,0,0,135,0,135,0,0,136,0,136,304,0,304,440
05/19/2020,WHP,CA,AWP,WE,Federal Contract Tower,0,0,0,0,0,0,0,107,0,107,0,0,107,0,107,170,0,170,277
05/20/2020,WHP,CA,AWP,WE,Federal Contract Tower,0,0,2,0,2,0,0,127,0,127,0,0,129,0,129,112,0,112,241
05/21/2020,WHP,CA,AWP,WE,Federal Contract Tower,0,0,1,0,1,0,0,174,0,174,0,0,175,0,175,320,0,320,495
05/22/2020,WHP,CA,AWP,WE,Federal Contract Tower,0,0,0,0,0,0,0,144,0,144,0,0,144,0,144,298,0,298,442
05/23/2020,WHP,CA,AWP,WE,Federal Contract Tower,0,0,0,0,0,0,0,180,0,180,0,0,180,0,180,294,0,294,474
05/24/2020,WHP,CA,AWP,WE,Federal Contract Tower,0,0,7,0,7,0,0,184,0,184,0,0,191,0,191,196,0,196,387
05/25/2020,WHP,CA,AWP,WE,Federal Contract Tower,0,0,3,0,3,0,0,102,0,102,0,0,105,0,105,132,0,132,237
05/26/2020,WHP,CA,AWP,WE,Federal Contract Tower,0,0,0,0,0,0,0,118,0,118,0,0,118,0,118,134,0,134,252
05/27/2020,WHP,CA,AWP,WE,Federal Contract Tower,0,0,3,0,3,0,0,99,0,99,0,0,102,0,102,168,0,168,270
05/28/2020,WHP,CA,AWP,WE,Federal Contract Tower,0,0,1,0,1,0,0,111,0,111,0,0,112,0,112,172,2,174,286
05/29/2020,WHP,CA,AWP,WE,Federal Contract Tower,0,0,5,0,5,0,0,89,0,89,0,0,94,0,94,144,0,144,238
05/30/2020,WHP,CA,AWP,WE,Federal Contract Tower,0,0,0,0,0,0,0,145,0,145,0,0,145,0,145,252,0,252,397
05/31/2020,WHP,CA,AWP,WE,Federal Contract Tower,0,0,1,0,1,0,0,181,0,181,0,0,182,0,182,230,0,230,412
06/01/2020,WHP,CA,AWP,WE,Federal Contract Tower,0,0,1,0,1,0,0,71,0,71,0,0,72,0,72,92,0,92,164
06/02/2020,WHP,CA,AWP,WE,Federal Contract Tower,0,0,2,0,2,0,0,120,0,120,0,0,122,0,122,82,0,82,204
06/03/2020,WHP,CA,AWP,WE,Federal Contract Tower,0,0,0,0,0,0,0,131,0,131,0,0,131,0,131,178,0,178,309
06/04/2020,WHP,CA,AWP,WE,Federal Contract Tower,0,0,1,0,1,0,0,177,0,177,0,0,178,0,178,268,0,268,446
06/05/2020,WHP,CA,AWP,WE,Federal Contract Tower,0,0,2,0,2,0,0,87,0,87,0,0,89,0,89,108,0,108,197
06/06/2020,WHP,CA,AWP,WE,Federal Contract Tower,0,0,5,0,5,0,0,164,0,164,0,0,169,0,169,358,0,358,527
06/07/2020,WHP,CA,AWP,WE,Federal Contract Tower,0,0,3,0,3,0,0,71,0,71,0,0,74,0,74,72,0,72,146
06/08/2020,WHP,CA,AWP,WE,Federal Contract Tower,0,0,0,0,0,0,0,48,0,48,0,0,48,0,48,0,0,0,48
06/09/2020,WHP,CA,AWP,WE,Federal Contract Tower,0,0,0,0,0,0,0,117,0,117,0,0,117,0,117,264,0,264,381
06/10/2020,WHP,CA,AWP,WE,Federal Contract Tower,0,0,2,0,2,0,0,131,0,131,0,0,133,0,133,80,0,80,213
06/11/2020,WHP,CA,AWP,WE,Federal Contract Tower,0,0,0,0,0,0,0,162,0,162,0,0,162,0,162,334,0,334,496
06/12/2020,WHP,CA,AWP,WE,Federal Contract Tower,0,0,0,0,0,0,0,92,0,92,0,0,92,0,92,166,0,166,258
06/13/2020,WHP,CA,AWP,WE,Federal Contract Tower,0,0,0,0,0,0,0,131,0,131,0,0,131,0,131,174,0,174,305
06/14/2020,WHP,CA,AWP,WE,Federal Contract Tower,0,0,1,0,1,0,0,177,0,177,0,0,178,0,178,54,0,54,232
06/15/2020,WHP,CA,AWP,WE,Federal Contract Tower,0,0,0,0,0,0,0,103,0,103,0,0,103,0,103,252,0,252,355
06/16/2020,WHP,CA,AWP,WE,Federal Contract Tower,0,0,3,0,3,0,0,43,0,43,0,0,46,0,46,94,0,94,140
06/17/2020,WHP,CA,AWP,WE,Federal Contract Tower,0,0,0,0,0,0,0,119,0,119,0,0,119,0,119,292,0,292,411
06/18/2020,WHP,CA,AWP,WE,Federal Contract Tower,0,0,2,0,2,0,0,67,0,67,0,0,69,0,69,132,0,132,201
06/19/2020,WHP,CA,AWP,WE,Federal Contract Tower,0,0,4,0,4,0,0,103,0,103,0,0,107,0,107,188,0,188,295
06/20/2020,WHP,CA,AWP,WE,Federal Contract Tower,0,0,6,0,6,0,0,93,0,93,0,0,99,0,99,186,0,186,285
06/21/2020,WHP,CA,AWP,WE,Federal Contract Tower,0,0,7,0,7,0,0,67,0,67,0,0,74,0,74,144,0,144,218
06/22/2020,WHP,CA,AWP,WE,Federal Contract Tower,0,0,3,0,3,0,0,99,0,99,0,0,102,0,102,136,0,136,238
06/23/2020,WHP,CA,AWP,WE,Federal Contract Tower,0,0,3,0,3,0,0,101,0,101,0,0,104,0,104,152,0,152,256
06/24/2020,WHP,CA,AWP,WE,Federal Contract Tower,0,0,2,0,2,0,0,98,0,98,0,0,100,0,100,96,0,96,196
06/25/2020,WHP,CA,AWP,WE,Federal Contract Tower,0,0,1,0,1,0,0,121,0,121,0,0,122,0,122,288,0,288,410
06/26/2020,WHP,CA,AWP,WE,Federal Contract Tower,0,0,2,0,2,0,0,126,0,126,0,0,128,0,128,228,0,228,356
06/27/2020,WHP,CA,AWP,WE,Federal Contract Tower,0,0,0,0,0,0,0,157,0,157,0,0,157,0,157,278,0,278,435
06/28/2020,WHP,CA,AWP,WE,Federal Contract Tower,0,0,8,0,8,0,0,61,0,61,0,0,69,0,69,84,0,84,153
06/29/2020,WHP,CA,AWP,WE,Federal Contract Tower,0,0,0,0,0,0,0,78,0,78,0,0,78,0,78,136,0,136,214
06/30/2020,WHP,CA,AWP,WE,Federal Contract Tower,0,0,0,0,0,0,0,131,0,131,0,0,131,0,131,124,0,124,255
07/01/2020,WHP,CA,AWP,WE,Federal Contract Tower,0,0,2,0,2,0,0,126,0,126,0,0,128,0,128,192,0,192,320
07/02/2020,WHP,CA,AWP,WE,Federal Contract Tower,0,0,2,0,2,0,0,126,0,126,0,0,128,0,128,154,0,154,282
07/03/2020,WHP,CA,AWP,WE,Federal Contract Tower,0,0,2,0,2,0,0,190,0,190,0,0,192,0,192,212,0,212,404
07/04/2020,WHP,CA,AWP,WE,Federal Contract Tower,0,0,0,0,0,0,0,109,0,109,0,0,109,0,109,46,0,46,155
07/05/2020,WHP,CA,AWP,WE,Federal Contract Tower,0,0,0,0,0,0,0,120,0,120,0,0,120,0,120,116,0,116,236
07/06/2020,WHP,CA,AWP,WE,Federal Contract Tower,0,0,0,0,0,0,0,89,0,89,0,0,89,0,89,138,0,138,227
07/07/2020,WHP,CA,AWP,WE,Federal Contract Tower,0,0,1,0,1,0,0,132,0,132,0,0,133,0,133,222,0,222,355
07/08/2020,WHP,CA,AWP,WE,Federal Contract Tower,0,0,0,0,0,0,0,124,0,124,0,0,124,0,124,190,0,190,314
07/09/2020,WHP,CA,AWP,WE,Federal Contract Tower,0,0,0,0,0,0,0,126,0,126,0,0,126,0,126,278,0,278,404
07/10/2020,WHP,CA,AWP,WE,Federal Contract Tower,0,0,0,0,0,0,0,106,0,106,0,0,106,0,106,152,0,152,258
07/11/2020,WHP,CA,AWP,WE,Federal Contract Tower,0,0,0,0,0,0,0,106,0,106,0,0,106,0,106,154,0,154,260
07/12/2020,WHP,CA,AWP,WE,Federal Contract Tower,0,0,2,0,2,0,0,111,0,111,0,0,113,0,113,124,0,124,237
07/13/2020,WHP,CA,AWP,WE,Federal Contract Tower,0,0,0,0,0,0,0,76,0,76,0,0,76,0,76,68,0,68,144
07/14/2020,WHP,CA,AWP,WE,Federal Contract Tower,0,0,3,0,3,0,0,129,0,129,0,0,132,0,132,212,0,212,344
07/15/2020,WHP,CA,AWP,WE,Federal Contract Tower,0,0,2,0,2,0,0,130,0,130,0,0,132,0,132,244,0,244,376
07/16/2020,WHP,CA,AWP,WE,Federal Contract Tower,0,0,6,0,6,0,0,122,0,122,0,0,128,0,128,200,0,200,328
07/17/2020,WHP,CA,AWP,WE,Federal Contract Tower,0,0,0,0,0,0,0,102,0,102,0,0,102,0,102,240,0,240,342
07/18/2020,WHP,CA,AWP,WE,Federal Contract Tower,0,0,0,0,0,0,0,113,0,113,0,0,113,0,113,196,0,196,309
07/19/2020,WHP,CA,AWP,WE,Federal Contract Tower,0,0,3,0,3,0,0,129,0,129,0,0,132,0,132,164,0,164,296
07/20/2020,WHP,CA,AWP,WE,Federal Contract Tower,0,0,0,0,0,0,0,112,0,112,0,0,112,0,112,158,0,158,270
07/21/2020,WHP,CA,AWP,WE,Federal Contract Tower,0,0,4,0,4,0,0,142,0,142,0,0,146,0,146,198,0,198,344
07/22/2020,WHP,CA,AWP,WE,Federal Contract Tower,0,0,0,0,0,0,0,120,0,120,0,0,120,0,120,168,0,168,288
07/23/2020,WHP,CA,AWP,WE,Federal Contract Tower,0,0,1,0,1,0,0,81,0,81,0,0,82,0,82,310,0,310,392
07/24/2020,WHP,CA,AWP,WE,Federal Contract Tower,0,0,1,0,1,0,0,132,0,132,0,0,133,0,133,220,0,220,353
07/25/2020,WHP,CA,AWP,WE,Federal Contract Tower,0,0,0,0,0,0,0,182,0,182,0,0,182,0,182,272,0,272,454
07/26/2020,WHP,CA,AWP,WE,Federal Contract Tower,0,0,0,0,0,0,0,125,0,125,0,0,125,0,125,200,0,200,325
07/27/2020,WHP,CA,AWP,WE,Federal Contract Tower,0,0,2,0,2,0,0,115,0,115,0,0,117,0,117,166,0,166,283
07/28/2020,WHP,CA,AWP,WE,Federal Contract Tower,0,0,1,0,1,0,0,146,0,146,0,0,147,0,147,232,0,232,379
07/29/2020,WHP,CA,AWP,WE,Federal Contract Tower,0,0,0,0,0,0,0,130,0,130,0,0,130,0,130,214,0,214,344
07/30/2020,WHP,CA,AWP,WE,Federal Contract Tower,0,0,0,0,0,0,0,140,0,140,0,0,140,0,140,288,0,288,428
07/31/2020,WHP,CA,AWP,WE,Federal Contract Tower,0,0,0,0,0,0,0,118,0,118,0,0,118,0,118,144,0,144,262
08/01/2020,WHP,CA,AWP,WE,Federal Contract Tower,0,0,1,0,1,0,0,163,0,163,0,0,164,0,164,286,0,286,450
08/02/2020,WHP,CA,AWP,WE,Federal Contract Tower,0,0,0,0,0,0,0,129,0,129,0,0,129,0,129,162,0,162,291
08/03/2020,WHP,CA,AWP,WE,Federal Contract Tower,0,0,5,0,5,0,0,130,0,130,0,0,135,0,135,200,0,200,335
08/04/2020,WHP,CA,AWP,WE,Federal Contract Tower,0,0,1,0,1,0,0,123,0,123,0,0,124,0,124,194,0,194,318
08/05/2020,WHP,CA,AWP,WE,Federal Contract Tower,0,0,1,0,1,0,0,121,0,121,0,0,122,0,122,194,0,194,316
08/06/2020,WHP,CA,AWP,WE,Federal Contract Tower,0,0,4,0,4,0,0,85,0,85,0,0,89,0,89,216,0,216,305
08/07/2020,WHP,CA,AWP,WE,Federal Contract Tower,0,0,1,0,1,0,0,93,0,93,0,0,94,0,94,86,0,86,180
08/08/2020,WHP,CA,AWP,WE,Federal Contract Tower,0,0,2,0,2,0,0,148,0,148,0,0,150,0,150,334,0,334,484
08/09/2020,WHP,CA,AWP,WE,Federal Contract Tower,0,0,2,0,2,0,0,144,0,144,0,0,146,0,146,170,0,170,316
08/10/2020,WHP,CA,AWP,WE,Federal Contract Tower,0,0,4,0,4,0,0,119,0,119,0,0,123,0,123,176,0,176,299
08/11/2020,WHP,CA,AWP,WE,Federal Contract Tower,0,0,0,0,0,0,0,169,0,169,0,0,169,0,169,294,0,294,463
08/12/2020,WHP,CA,AWP,WE,Federal Contract Tower,0,0,0,0,0,0,0,141,0,141,0,0,141,0,141,158,0,158,299
08/13/2020,WHP,CA,AWP,WE,Federal Contract Tower,0,0,0,0,0,0,0,105,0,105,0,0,105,0,105,114,0,114,219
08/14/2020,WHP,CA,AWP,WE,Federal Contract Tower,0,0,0,0,0,0,0,105,0,105,0,0,105,0,105,150,0,150,255
08/15/2020,WHP,CA,AWP,WE,Federal Contract Tower,0,0,0,0,0,0,0,107,0,107,0,0,107,0,107,122,0,122,229
08/16/2020,WHP,CA,AWP,WE,Federal Contract Tower,0,0,0,0,0,0,0,128,0,128,0,0,128,0,128,128,0,128,256
08/17/2020,WHP,CA,AWP,WE,Federal Contract Tower,0,0,3,0,3,0,0,135,0,135,0,0,138,0,138,252,0,252,390
08/18/2020,WHP,CA,AWP,WE,Federal Contract Tower,0,0,1,0,1,0,0,94,0,94,0,0,95,0,95,122,0,122,217
08/19/2020,WHP,CA,AWP,WE,Federal Contract Tower,0,0,0,0,0,0,0,86,0,86,0,0,86,0,86,36,0,36,122
08/20/2020,WHP,CA,AWP,WE,Federal Contract Tower,0,0,2,0,2,0,0,102,0,102,0,0,104,0,104,224,0,224,328
08/21/2020,WHP,CA,AWP,WE,Federal Contract Tower,0,0,2,0,2,0,0,100,0,100,0,0,102,0,102,258,0,258,360
08/22/2020,WHP,CA,AWP,WE,Federal Contract Tower,0,0,1,0,1,0,0,147,0,147,0,0,148,0,148,182,0,182,330
08/23/2020,WHP,CA,AWP,WE,Federal Contract Tower,0,0,2,0,2,0,0,156,0,156,0,0,158,0,158,236,0,236,394
08/24/2020,WHP,CA,AWP,WE,Federal Contract Tower,0,0,1,0,1,0,0,145,0,145,0,0,146,0,146,258,0,258,404
08/25/2020,WHP,CA,AWP,WE,Federal Contract Tower,0,0,2,0,2,0,0,113,0,113,0,0,115,0,115,270,0,270,385
08/26/2020,WHP,CA,AWP,WE,Federal Contract Tower,0,0,0,0,0,0,0,112,0,112,0,0,112,0,112,218,0,218,330
08/27/2020,WHP,CA,AWP,WE,Federal Contract Tower,0,0,1,0,1,0,0,160,0,160,0,0,161,0,161,358,2,360,521
08/28/2020,WHP,CA,AWP,WE,Federal Contract Tower,0,0,0,0,0,0,22,149,0,171,0,22,149,0,171,306,0,306,477
08/29/2020,WHP,CA,AWP,WE,Federal Contract Tower,0,0,3,0,3,0,0,211,0,211,0,0,214,0,214,340,0,340,554
08/30/2020,WHP,CA,AWP,WE,Federal Contract Tower,0,0,5,0,5,0,0,135,0,135,0,0,140,0,140,228,0,228,368
08/31/2020,WHP,CA,AWP,WE,Federal Contract Tower,0,0,3,0,3,0,0,167,0,167,0,0,170,0,170,292,0,292,462
09/01/2020,WHP,CA,AWP,WE,Federal Contract Tower,0,0,2,0,2,0,0,128,0,128,0,0,130,0,130,264,0,264,394
09/02/2020,WHP,CA,AWP,WE,Federal Contract Tower,0,0,3,0,3,0,0,187,0,187,0,0,190,0,190,336,0,336,526
09/03/2020,WHP,CA,AWP,WE,Federal Contract Tower,0,0,0,0,0,0,0,163,0,163,0,0,163,0,163,383,0,383,546
09/04/2020,WHP,CA,AWP,WE,Federal Contract Tower,0,0,0,0,0,0,0,161,0,161,0,0,161,0,161,216,0,216,377
09/05/2020,WHP,CA,AWP,WE,Federal Contract Tower,0,0,1,0,1,0,0,50,0,50,0,0,51,0,51,62,0,62,113
09/06/2020,WHP,CA,AWP,WE,Federal Contract Tower,0,0,1,0,1,0,0,64,0,64,0,0,65,0,65,0,0,0,65
09/07/2020,WHP,CA,AWP,WE,Federal Contract Tower,0,0,2,0,2,0,0,70,0,70,0,0,72,0,72,118,0,118,190
09/08/2020,WHP,CA,AWP,WE,Federal Contract Tower,0,0,5,0,5,0,0,100,0,100,0,0,105,0,105,164,0,164,269
09/09/2020,WHP,CA,AWP,WE,Federal Contract Tower,0,0,1,0,1,0,0,93,0,93,0,0,94,0,94,160,0,160,254
09/10/2020,WHP,CA,AWP,WE,Federal Contract Tower,0,0,3,0,3,0,0,112,0,112,0,0,115,0,115,214,0,214,329
09/11/2020,WHP,CA,AWP,WE,Federal Contract Tower,0,0,1,0,1,0,0,71,0,71,0,0,72,0,72,116,0,116,188
09/12/2020,WHP,CA,AWP,WE,Federal Contract Tower,0,0,4,0,4,0,0,16,0,16,0,0,20,0,20,0,0,0,20
09/13/2020,WHP,CA,AWP,WE,Federal Contract Tower,0,0,1,0,1,0,0,82,0,82,0,0,83,0,83,108,0,108,191
09/14/2020,WHP,CA,AWP,WE,Federal Contract Tower,0,0,3,0,3,0,0,40,0,40,0,0,43,0,43,70,0,70,113
09/15/2020,WHP,CA,AWP,WE,Federal Contract Tower,0,0,3,0,3,0,0,66,0,66,0,0,69,0,69,150,0,150,219
09/16/2020,WHP,CA,AWP,WE,Federal Contract Tower,0,0,0,0,0,0,0,116,0,116,0,0,116,0,116,282,0,282,398
09/17/2020,WHP,CA,AWP,WE,Federal Contract Tower,0,0,3,0,3,0,0,77,0,77,0,0,80,0,80,124,0,124,204
09/18/2020,WHP,CA,AWP,WE,Federal Contract Tower,0,0,0,0,0,0,0,77,0,77,0,0,77,0,77,30,0,30,107
09/19/2020,WHP,CA,AWP,WE,Federal Contract Tower,0,0,1,0,1,0,0,129,0,129,0,0,130,0,130,240,0,240,370
09/20/2020,WHP,CA,AWP,WE,Federal Contract Tower,0,0,0,0,0,0,0,256,0,256,0,0,256,0,256,316,0,316,572
09/21/2020,WHP,CA,AWP,WE,Federal Contract Tower,0,0,1,0,1,0,0,80,0,80,0,0,81,0,81,126,0,126,207
09/22/2020,WHP,CA,AWP,WE,Federal Contract Tower,0,0,0,0,0,0,0,122,0,122,0,0,122,0,122,266,0,266,388
09/23/2020,WHP,CA,AWP,WE,Federal Contract Tower,0,0,0,0,0,0,0,138,0,138,0,0,138,0,138,282,0,282,420
09/24/2020,WHP,CA,AWP,WE,Federal Contract Tower,0,0,2,0,2,0,0,145,0,145,0,0,147,0,147,198,0,198,345
09/25/2020,WHP,CA,AWP,WE,Federal Contract Tower,2,0,0,0,2,0,0,111,0,111,2,0,111,0,113,206,0,206,319
09/26/2020,WHP,CA,AWP,WE,Federal Contract Tower,1,0,7,0,8,0,0,116,0,116,1,0,123,0,124,224,0,224,348
09/27/2020,WHP,CA,AWP,WE,Federal Contract Tower,0,0,4,0,4,0,0,137,0,137,0,0,141,0,141,200,0,200,341
09/28/2020,WHP,CA,AWP,WE,Federal Contract Tower,0,0,1,0,1,0,0,102,0,102,0,0,103,0,103,130,0,130,233
09/29/2020,WHP,CA,AWP,WE,Federal Contract Tower,0,0,0,0,0,0,0,139,0,139,0,0,139,0,139,232,0,232,371
09/30/2020,WHP,CA,AWP,WE,Federal Contract Tower,0,0,2,0,2,0,0,133,0,133,0,0,135,0,135,186,0,186,321
10/01/2020,WHP,CA,AWP,WE,Federal Contract Tower,0,0,0,0,0,0,0,96,0,96,0,0,96,0,96,100,0,100,196
10/02/2020,WHP,CA,AWP,WE,Federal Contract Tower,0,2,0,0,2,0,0,112,0,112,0,2,112,0,114,180,0,180,294
10/03/2020,WHP,CA,AWP,WE,Federal Contract Tower,0,0,0,0,0,0,0,151,0,151,0,0,151,0,151,346,0,346,497
10/04/2020,WHP,CA,AWP,WE,Federal Contract Tower,0,0,0,0,0,0,0,162,0,162,0,0,162,0,162,244,0,244,406
10/05/2020,WHP,CA,AWP,WE,Federal Contract Tower,0,0,0,0,0,0,0,177,0,177,0,0,177,0,177,224,0,224,401
10/06/2020,WHP,CA,AWP,WE,Federal Contract Tower,0,0,1,0,1,0,0,138,0,138,0,0,139,0,139,202,0,202,341
10/07/2020,WHP,CA,AWP,WE,Federal Contract Tower,0,0,1,0,1,0,0,164,0,164,0,0,165,0,165,232,0,232,397
10/08/2020,WHP,CA,AWP,WE,Federal Contract Tower,0,0,4,0,4,0,0,155,0,155,0,0,159,0,159,268,0,268,427
10/09/2020,WHP,CA,AWP,WE,Federal Contract Tower,0,0,8,0,8,0,0,75,0,75,0,0,83,0,83,218,0,218,301
10/10/2020,WHP,CA,AWP,WE,Federal Contract Tower,0,0,7,0,7,0,94,0,0,94,0,94,7,0,101,204,0,204,305
10/11/2020,WHP,CA,AWP,WE,Federal Contract Tower,0,0,2,0,2,0,0,207,0,207,0,0,209,0,209,340,0,340,549
10/12/2020,WHP,CA,AWP,WE,Federal Contract Tower,0,0,0,0,0,0,0,177,0,177,0,0,177,0,177,346,0,346,523
10/13/2020,WHP,CA,AWP,WE,Federal Contract Tower,0,0,0,0,0,0,0,165,0,165,0,0,165,0,165,208,0,208,373
10/14/2020,WHP,CA,AWP,WE,Federal Contract Tower,0,0,0,0,0,0,0,162,0,162,0,0,162,0,162,258,0,258,420
10/15/2020,WHP,CA,AWP,WE,Federal Contract Tower,0,0,2,0,2,0,0,148,0,148,0,0,150,0,150,316,0,316,466
10/16/2020,WHP,CA,AWP,WE,Federal Contract Tower,0,0,0,0,0,0,0,157,0,157,0,0,157,0,157,228,0,228,385
10/17/2020,WHP,CA,AWP,WE,Federal Contract Tower,0,0,0,0,0,0,0,177,0,177,0,0,177,0,177,278,0,278,455
10/18/2020,WHP,CA,AWP,WE,Federal Contract Tower,0,0,1,0,1,0,0,186,0,186,0,0,187,0,187,146,0,146,333
10/19/2020,WHP,CA,AWP,WE,Federal Contract Tower,0,0,1,0,1,0,0,108,0,108,0,0,109,0,109,130,0,130,239
10/20/2020,WHP,CA,AWP,WE,Federal Contract Tower,0,0,1,0,1,0,0,102,0,102,0,0,103,0,103,218,0,218,321
10/21/2020,WHP,CA,AWP,WE,Federal Contract Tower,0,0,2,1,3,0,0,0,71,71,0,0,2,72,74,72,0,72,146
10/22/2020,WHP,CA,AWP,WE,Federal Contract Tower,0,0,3,0,3,0,0,43,0,43,0,0,46,0,46,150,0,150,196
10/23/2020,WHP,CA,AWP,WE,Federal Contract Tower,0,0,4,0,4,0,0,110,0,110,0,0,114,0,114,240,0,240,354
10/24/2020,WHP,CA,AWP,WE,Federal Contract Tower,0,0,6,0,6,0,0,89,0,89,0,0,95,0,95,134,0,134,229
10/25/2020,WHP,CA,AWP,WE,Federal Contract Tower,0,0,6,0,6,0,0,126,0,126,0,0,132,0,132,284,0,284,416
10/26/2020,WHP,CA,AWP,WE,Federal Contract Tower,0,0,0,0,0,0,0,28,0,28,0,0,28,0,28,0,0,0,28
10/27/2020,WHP,CA,AWP,WE,Federal Contract Tower,0,0,0,0,0,0,0,107,0,107,0,0,107,0,107,46,0,46,153
10/28/2020,WHP,CA,AWP,WE,Federal Contract Tower,0,0,2,0,2,0,0,226,0,226,0,0,228,0,228,296,0,296,524
10/29/2020,WHP,CA,AWP,WE,Federal Contract Tower,0,0,0,0,0,0,0,154,0,154,0,0,154,0,154,242,0,242,396
10/30/2020,WHP,CA,AWP,WE,Federal Contract Tower,0,0,2,0,2,0,0,174,0,174,0,0,176,0,176,366,0,366,542
10/31/2020,WHP,CA,AWP,WE,Federal Contract Tower,0,0,1,0,1,0,0,249,0,249,0,0,250,0,250,320,0,320,570
11/01/2020,WHP,CA,AWP,WE,Federal Contract Tower,0,0,0,0,0,0,0,152,0,152,0,0,152,0,152,222,0,222,374
11/02/2020,WHP,CA,AWP,WE,Federal Contract Tower,0,0,0,0,0,0,0,140,0,140,0,0,140,0,140,192,0,192,332
11/03/2020,WHP,CA,AWP,WE,Federal Contract Tower,0,0,0,0,0,0,0,204,0,204,0,0,204,0,204,302,0,302,506
11/04/2020,WHP,CA,AWP,WE,Federal Contract Tower,0,0,3,0,3,0,0,186,0,186,0,0,189,0,189,296,0,296,485
11/05/2020,WHP,CA,AWP,WE,Federal Contract Tower,0,0,0,0,0,0,0,135,0,135,0,0,135,0,135,196,0,196,331
11/06/2020,WHP,CA,AWP,WE,Federal Contract Tower,0,0,2,0,2,0,0,151,0,151,0,0,153,0,153,266,0,266,419
11/07/2020,WHP,CA,AWP,WE,Federal Contract Tower,0,0,0,0,0,0,0,51,0,51,0,0,51,0,51,46,0,46,97
11/08/2020,WHP,CA,AWP,WE,Federal Contract Tower,0,0,0,0,0,0,0,25,0,25,0,0,25,0,25,44,0,44,69
11/09/2020,WHP,CA,AWP,WE,Federal Contract Tower,0,0,0,0,0,0,0,156,0,156,0,0,156,0,156,162,0,162,318
11/10/2020,WHP,CA,AWP,WE,Federal Contract Tower,0,0,2,0,2,0,0,161,0,161,0,0,163,0,163,272,0,272,435
11/11/2020,WHP,CA,AWP,WE,Federal Contract Tower,0,0,0,0,0,0,0,162,0,162,0,0,162,0,162,196,0,196,358
11/12/2020,WHP,CA,AWP,WE,Federal Contract Tower,0,0,0,0,0,0,0,98,0,98,0,0,98,0,98,36,0,36,134
11/13/2020,WHP,CA,AWP,WE,Federal Contract Tower,0,0,0,0,0,0,0,160,0,160,0,0,160,0,160,300,0,300,460
11/14/2020,WHP,CA,AWP,WE,Federal Contract Tower,0,0,0,0,0,0,0,138,0,138,0,0,138,0,138,162,0,162,300
11/15/2020,WHP,CA,AWP,WE,Federal Contract Tower,0,0,0,0,0,0,0,222,0,222,0,0,222,0,222,242,0,242,464
11/16/2020,WHP,CA,AWP,WE,Federal Contract Tower,0,0,0,0,0,0,0,109,0,109,0,0,109,0,109,128,0,128,237
11/17/2020,WHP,CA,AWP,WE,Federal Contract Tower,0,0,0,0,0,0,0,90,0,90,0,0,90,0,90,114,0,114,204
11/18/2020,WHP,CA,AWP,WE,Federal Contract Tower,0,0,0,0,0,0,0,127,0,127,0,0,127,0,127,102,0,102,229
11/19/2020,WHP,CA,AWP,WE,Federal Contract Tower,0,0,0,0,0,0,0,122,0,122,0,0,122,0,122,172,0,172,294
11/20/2020,WHP,CA,AWP,WE,Federal Contract Tower,0,0,0,0,0,0,0,115,0,115,0,0,115,0,115,148,0,148,263
11/21/2020,WHP,CA,AWP,WE,Federal Contract Tower,0,0,0,0,0,0,0,149,0,149,0,0,149,0,149,202,0,202,351
11/22/2020,WHP,CA,AWP,WE,Federal Contract Tower,0,0,0,0,0,0,0,155,0,155,0,0,155,0,155,190,0,190,345
11/23/2020,WHP,CA,AWP,WE,Federal Contract Tower,0,0,0,0,0,0,0,110,0,110,0,0,110,0,110,126,0,126,236
11/24/2020,WHP,CA,AWP,WE,Federal Contract Tower,0,0,1,0,1,0,0,141,0,141,0,0,142,0,142,184,0,184,326
11/25/2020,WHP,CA,AWP,WE,Federal Contract Tower,0,0,0,0,0,0,0,186,0,186,0,0,186,0,186,168,0,168,354
11/26/2020,WHP,CA,AWP,WE,Federal Contract Tower,0,0,0,0,0,0,0,30,0,30,0,0,30,0,30,20,0,20,50
11/27/2020,WHP,CA,AWP,WE,Federal Contract Tower,0,0,0,0,0,0,0,79,0,79,0,0,79,0,79,14,0,14,93
11/30/2020,WHP,CA,AWP,WE,Federal Contract Tower,0,0,0,0,0,0,0,116,0,116,0,0,116,0,116,180,0,180,296
12/01/2020,WHP,CA,AWP,WE,Federal Contract Tower,0,0,0,0,0,0,0,141,0,141,0,0,141,0,141,240,0,240,381
12/02/2020,WHP,CA,AWP,WE,Federal Contract Tower,0,0,0,0,0,0,0,139,0,139,0,0,139,0,139,150,0,150,289
12/03/2020,WHP,CA,AWP,WE,Federal Contract Tower,0,0,0,0,0,63,0,0,0,63,63,0,0,0,63,52,0,52,115
12/04/2020,WHP,CA,AWP,WE,Federal Contract Tower,0,0,0,0,0,0,0,126,0,126,0,0,126,0,126,104,0,104,230
12/05/2020,WHP,CA,AWP,WE,Federal Contract Tower,0,0,0,0,0,0,0,147,0,147,0,0,147,0,147,244,0,244,391
12/06/2020,WHP,CA,AWP,WE,Federal Contract Tower,0,0,4,0,4,0,0,184,0,184,0,0,188,0,188,256,0,256,444
12/08/2020,WHP,CA,AWP,WE,Federal Contract Tower,0,0,0,0,0,0,0,55,0,55,0,0,55,0,55,32,0,32,87
12/09/2020,WHP,CA,AWP,WE,Federal Contract Tower,0,0,0,0,0,0,0,0,0,0,0,0,0,0,0,178,0,178,178
12/10/2020,WHP,CA,AWP,WE,Federal Contract Tower,0,0,0,0,0,0,0,149,0,149,0,0,149,0,149,258,0,258,407
12/11/2020,WHP,CA,AWP,WE,Federal Contract Tower,0,0,0,0,0,0,0,89,0,89,0,0,89,0,89,128,0,128,217
12/12/2020,WHP,CA,AWP,WE,Federal Contract Tower,0,0,0,0,0,0,0,125,0,125,0,0,125,0,125,142,0,142,267
12/13/2020,WHP,CA,AWP,WE,Federal Contract Tower,0,0,1,0,1,0,0,209,0,209,0,0,210,0,210,316,0,316,526
12/14/2020,WHP,CA,AWP,WE,Federal Contract Tower,0,0,0,0,0,0,0,24,0,24,0,0,24,0,24,18,0,18,42
12/15/2020,WHP,CA,AWP,WE,Federal Contract Tower,0,0,0,0,0,0,0,50,0,50,0,0,50,0,50,0,0,0,50
12/16/2020,WHP,CA,AWP,WE,Federal Contract Tower,0,0,0,0,0,0,0,131,0,131,0,0,131,0,131,60,0,60,191
12/17/2020,WHP,CA,AWP,WE,Federal Contract Tower,0,0,0,0,0,0,0,135,0,135,0,0,135,0,135,214,0,214,349
12/18/2020,WHP,CA,AWP,WE,Federal Contract Tower,0,0,0,0,0,0,0,100,0,100,0,0,100,0,100,80,0,80,180
12/19/2020,WHP,CA,AWP,WE,Federal Contract Tower,0,0,3,0,3,0,0,181,0,181,0,0,184,0,184,294,0,294,478
12/20/2020,WHP,CA,AWP,WE,Federal Contract Tower,0,0,1,0,1,0,0,167,0,167,0,0,168,0,168,230,0,230,398
12/21/2020,WHP,CA,AWP,WE,Federal Contract Tower,0,0,0,0,0,0,149,0,0,149,0,149,0,0,149,98,0,98,247
12/22/2020,WHP,CA,AWP,WE,Federal Contract Tower,0,0,0,0,0,0,0,149,0,149,0,0,149,0,149,184,0,184,333
12/23/2020,WHP,CA,AWP,WE,Federal Contract Tower,0,0,1,0,1,0,0,90,0,90,0,0,91,0,91,132,0,132,223
12/24/2020,WHP,CA,AWP,WE,Federal Contract Tower,0,0,0,0,0,0,0,45,0,45,0,0,45,0,45,40,0,40,85
12/25/2020,WHP,CA,AWP,WE,Federal Contract Tower,0,0,0,0,0,0,0,71,0,71,0,0,71,0,71,46,0,46,117
12/26/2020,WHP,CA,AWP,WE,Federal Contract Tower,0,0,0,0,0,0,0,131,0,131,0,0,131,0,131,182,0,182,313
12/27/2020,WHP,CA,AWP,WE,Federal Contract Tower,0,0,0,0,0,0,0,121,0,121,0,0,121,0,121,195,0,195,316
12/28/2020,WHP,CA,AWP,WE,Federal Contract Tower,0,0,0,0,0,0,0,13,0,13,0,0,13,0,13,14,0,14,27
12/29/2020,WHP,CA,AWP,WE,Federal Contract Tower,0,0,0,0,0,0,0,115,0,115,0,0,115,0,115,142,0,142,257
12/30/2020,WHP,CA,AWP,WE,Federal Contract Tower,0,0,3,0,3,0,0,18,0,18,0,0,21,0,21,234,0,234,255
12/31/2020,WHP,CA,AWP,WE,Federal Contract Tower,0,0,2,0,2,0,0,60,0,60,0,0,62,0,62,2,0,2,64
01/01/2021,WHP,CA,AWP,WE,Federal Contract Tower,0,0,0,0,0,0,0,66,0,66,0,0,66,0,66,20,0,20,86
01/02/2021,WHP,CA,AWP,WE,Federal Contract Tower,0,0,5,0,5,0,0,178,0,178,0,0,183,0,183,352,0,352,535
01/03/2021,WHP,CA,AWP,WE,Federal Contract Tower,0,0,2,0,2,0,0,137,0,137,0,0,139,0,139,160,0,160,299
01/04/2021,WHP,CA,AWP,WE,Federal Contract Tower,0,0,3,0,3,0,0,117,0,117,0,0,120,0,120,240,0,240,360
01/05/2021,WHP,CA,AWP,WE,Federal Contract Tower,0,0,0,0,0,0,0,146,0,146,0,0,146,0,146,216,0,216,362
01/06/2021,WHP,CA,AWP,WE,Federal Contract Tower,0,0,0,0,0,0,0,154,0,154,0,0,154,0,154,170,0,170,324
01/07/2021,WHP,CA,AWP,WE,Federal Contract Tower,0,0,0,0,0,0,0,155,0,155,0,0,155,0,155,196,0,196,351
01/08/2021,WHP,CA,AWP,WE,Federal Contract Tower,0,0,3,0,3,0,0,85,0,85,0,0,88,0,88,88,0,88,176
01/09/2021,WHP,CA,AWP,WE,Federal Contract Tower,0,0,0,0,0,0,0,20,0,20,0,0,20,0,20,2,0,2,22
01/10/2021,WHP,CA,AWP,WE,Federal Contract Tower,0,0,0,0,0,0,0,162,0,162,0,0,162,0,162,300,0,300,462
01/11/2021,WHP,CA,AWP,WE,Federal Contract Tower,0,0,1,0,1,0,0,107,0,107,0,0,108,0,108,224,0,224,332
01/12/2021,WHP,CA,AWP,WE,Federal Contract Tower,0,0,0,0,0,0,0,142,0,142,0,0,142,0,142,182,0,182,324
01/13/2021,WHP,CA,AWP,WE,Federal Contract Tower,0,0,0,0,0,0,0,114,0,114,0,0,114,0,114,44,0,44,158
01/14/2021,WHP,CA,AWP,WE,Federal Contract Tower,0,0,0,0,0,0,0,128,0,128,0,0,128,0,128,128,0,128,256
01/15/2021,WHP,CA,AWP,WE,Federal Contract Tower,0,0,0,0,0,0,0,65,0,65,0,0,65,0,65,18,0,18,83
01/17/2021,WHP,CA,AWP,WE,Federal Contract Tower,0,0,1,0,1,0,0,163,0,163,0,0,164,0,164,280,0,280,444
01/18/2021,WHP,CA,AWP,WE,Federal Contract Tower,0,0,0,0,0,0,0,84,0,84,0,0,84,0,84,32,0,32,116
01/19/2021,WHP,CA,AWP,WE,Federal Contract Tower,0,0,0,0,0,0,0,29,0,29,0,0,29,0,29,0,0,0,29
01/20/2021,WHP,CA,AWP,WE,Federal Contract Tower,0,0,0,0,0,0,0,35,0,35,0,0,35,0,35,0,0,0,35
01/21/2021,WHP,CA,AWP,WE,Federal Contract Tower,0,0,5,0,5,0,0,117,0,117,0,0,122,0,122,260,0,260,382
01/22/2021,WHP,CA,AWP,WE,Federal Contract Tower,0,0,12,0,12,0,0,54,0,54,0,0,66,0,66,60,0,60,126
01/23/2021,WHP,CA,AWP,WE,Federal Contract Tower,0,0,8,0,8,0,0,48,0,48,0,0,56,0,56,72,0,72,128
01/24/2021,WHP,CA,AWP,WE,Federal Contract Tower,0,0,0,0,0,0,0,214,0,214,0,0,214,0,214,348,0,348,562
01/25/2021,WHP,CA,AWP,WE,Federal Contract Tower,0,0,1,0,1,0,0,20,0,20,0,0,21,0,21,0,0,0,21
01/26/2021,WHP,CA,AWP,WE,Federal Contract Tower,0,0,1,0,1,0,0,135,0,135,0,0,136,0,136,128,0,128,264
01/27/2021,WHP,CA,AWP,WE,Federal Contract Tower,0,0,0,0,0,0,0,39,0,39,0,0,39,0,39,0,0,0,39
01/28/2021,WHP,CA,AWP,WE,Federal Contract Tower,0,0,4,0,4,0,0,50,0,50,0,0,54,0,54,4,0,4,58
01/29/2021,WHP,CA,AWP,WE,Federal Contract Tower,0,0,0,0,0,0,0,30,0,30,0,0,30,0,30,0,0,0,30
01/30/2021,WHP,CA,AWP,WE,Federal Contract Tower,0,0,0,0,0,0,0,232,0,232,0,0,232,0,232,182,0,182,414
01/31/2021,WHP,CA,AWP,WE,Federal Contract Tower,0,0,1,0,1,0,0,141,0,141,0,0,142,0,142,192,0,192,334
02/01/2021,WHP,CA,AWP,WE,Federal Contract Tower,0,0,3,0,3,0,0,83,0,83,0,0,86,0,86,174,0,174,260
02/02/2021,WHP,CA,AWP,WE,Federal Contract Tower,0,0,1,0,1,0,0,196,0,196,0,0,197,0,197,284,0,284,481
02/03/2021,WHP,CA,AWP,WE,Federal Contract Tower,0,0,1,0,1,0,0,166,0,166,0,0,167,0,167,242,0,242,409
02/04/2021,WHP,CA,AWP,WE,Federal Contract Tower,0,0,13,0,13,0,0,135,0,135,0,0,148,0,148,116,0,116,264
02/05/2021,WHP,CA,AWP,WE,Federal Contract Tower,0,0,4,0,4,0,0,172,0,172,0,0,176,0,176,256,0,256,432
02/06/2021,WHP,CA,AWP,WE,Federal Contract Tower,0,0,4,0,4,0,0,394,0,394,0,0,398,0,398,368,0,368,766
02/07/2021,WHP,CA,AWP,WE,Federal Contract Tower,0,0,0,0,0,0,0,217,0,217,0,0,217,0,217,242,0,242,459
02/08/2021,WHP,CA,AWP,WE,Federal Contract Tower,0,0,2,0,2,0,0,110,0,110,0,0,112,0,112,186,0,186,298
02/09/2021,WHP,CA,AWP,WE,Federal Contract Tower,0,0,2,0,2,0,0,61,0,61,0,0,63,0,63,120,0,120,183
02/10/2021,WHP,CA,AWP,WE,Federal Contract Tower,0,0,0,0,0,0,0,153,0,153,0,0,153,0,153,340,0,340,493
02/11/2021,WHP,CA,AWP,WE,Federal Contract Tower,0,0,2,0,2,0,0,120,0,120,0,0,122,0,122,188,0,188,310
02/12/2021,WHP,CA,AWP,WE,Federal Contract Tower,0,0,6,0,6,0,0,41,0,41,0,0,47,0,47,0,0,0,47
02/13/2021,WHP,CA,AWP,WE,Federal Contract Tower,0,0,4,0,4,0,0,44,0,44,0,0,48,0,48,82,0,82,130
02/14/2021,WHP,CA,AWP,WE,Federal Contract Tower,0,0,1,0,1,0,0,22,0,22,0,0,23,0,23,6,0,6,29
02/15/2021,WHP,CA,AWP,WE,Federal Contract Tower,0,0,4,0,4,0,0,135,0,135,0,0,139,0,139,222,0,222,361
02/16/2021,WHP,CA,AWP,WE,Federal Contract Tower,0,0,1,0,1,0,0,36,0,36,0,0,37,0,37,26,0,26,63
02/17/2021,WHP,CA,AWP,WE,Federal Contract Tower,0,0,1,0,1,0,0,79,0,79,0,0,80,0,80,30,0,30,110
02/18/2021,WHP,CA,AWP,WE,Federal Contract Tower,0,0,0,0,0,0,0,105,0,105,0,0,105,0,105,114,0,114,219
02/19/2021,WHP,CA,AWP,WE,Federal Contract Tower,0,0,4,0,4,0,0,168,0,168,0,0,172,0,172,282,0,282,454
02/20/2021,WHP,CA,AWP,WE,Federal Contract Tower,0,0,0,0,0,0,0,29,0,29,0,0,29,0,29,0,0,0,29
02/21/2021,WHP,CA,AWP,WE,Federal Contract Tower,0,0,0,0,0,0,0,128,0,128,0,0,128,0,128,156,0,156,284
02/22/2021,WHP,CA,AWP,WE,Federal Contract Tower,0,0,0,0,0,0,0,131,0,131,0,0,131,0,131,162,0,162,293
02/23/2021,WHP,CA,AWP,WE,Federal Contract Tower,0,0,0,0,0,0,0,186,0,186,0,0,186,0,186,288,0,288,474
02/24/2021,WHP,CA,AWP,WE,Federal Contract Tower,0,0,0,0,0,0,0,207,0,207,0,0,207,0,207,342,0,342,549
02/25/2021,WHP,CA,AWP,WE,Federal Contract Tower,0,0,0,0,0,0,0,67,0,67,0,0,67,0,67,18,0,18,85
02/26/2021,WHP,CA,AWP,WE,Federal Contract Tower,0,0,0,0,0,0,0,149,0,149,0,0,149,0,149,278,0,278,427
02/27/2021,WHP,CA,AWP,WE,Federal Contract Tower,0,0,0,0,0,0,0,23,0,23,0,0,23,0,23,0,0,0,23
02/28/2021,WHP,CA,AWP,WE,Federal Contract Tower,0,0,0,0,0,0,0,25,0,25,0,0,25,0,25,40,0,40,65
03/01/2021,WHP,CA,AWP,WE,Federal Contract Tower,0,0,0,0,0,0,0,152,0,152,0,0,152,0,152,208,0,208,360
03/02/2021,WHP,CA,AWP,WE,Federal Contract Tower,0,0,0,0,0,0,0,147,0,147,0,0,147,0,147,298,0,298,445
03/03/2021,WHP,CA,AWP,WE,Federal Contract Tower,0,0,2,0,2,0,0,49,0,49,0,0,51,0,51,18,0,18,69
03/04/2021,WHP,CA,AWP,WE,Federal Contract Tower,0,0,0,0,0,0,0,148,0,148,0,0,148,0,148,266,0,266,414
03/05/2021,WHP,CA,AWP,WE,Federal Contract Tower,0,0,0,0,0,0,0,154,0,154,0,0,154,0,154,284,0,284,438
03/06/2021,WHP,CA,AWP,WE,Federal Contract Tower,0,0,0,0,0,0,0,241,0,241,0,0,241,0,241,386,0,386,627
03/07/2021,WHP,CA,AWP,WE,Federal Contract Tower,0,0,7,0,7,0,0,189,0,189,0,0,196,0,196,386,0,386,582
03/08/2021,WHP,CA,AWP,WE,Federal Contract Tower,0,0,7,0,7,0,0,105,0,105,0,0,112,0,112,182,0,182,294
03/09/2021,WHP,CA,AWP,WE,Federal Contract Tower,0,0,0,0,0,0,0,117,0,117,0,0,117,0,117,260,0,260,377
03/10/2021,WHP,CA,AWP,WE,Federal Contract Tower,0,0,0,0,0,0,0,32,0,32,0,0,32,0,32,24,0,24,56
03/11/2021,WHP,CA,AWP,WE,Federal Contract Tower,0,0,2,0,2,0,0,70,0,70,0,0,72,0,72,64,0,64,136
03/12/2021,WHP,CA,AWP,WE,Federal Contract Tower,0,0,2,0,2,0,0,60,0,60,0,0,62,0,62,106,0,106,168
03/13/2021,WHP,CA,AWP,WE,Federal Contract Tower,0,0,4,0,4,0,0,215,0,215,0,0,219,0,219,324,0,324,543
03/14/2021,WHP,CA,AWP,WE,Federal Contract Tower,0,0,0,0,0,0,0,177,0,177,0,0,177,0,177,316,0,316,493
03/15/2021,WHP,CA,AWP,WE,Federal Contract Tower,0,0,0,0,0,0,0,19,0,19,0,0,19,0,19,18,0,18,37
03/16/2021,WHP,CA,AWP,WE,Federal Contract Tower,0,0,3,0,3,0,0,151,0,151,0,0,154,0,154,294,0,294,448
03/17/2021,WHP,CA,AWP,WE,Federal Contract Tower,0,0,0,0,0,0,0,161,0,161,0,0,161,0,161,324,0,324,485
03/18/2021,WHP,CA,AWP,WE,Federal Contract Tower,0,0,4,0,4,0,0,120,0,120,0,0,124,0,124,150,0,150,274
03/19/2021,WHP,CA,AWP,WE,Federal Contract Tower,0,0,0,0,0,0,0,141,0,141,0,0,141,0,141,260,0,260,401
03/20/2021,WHP,CA,AWP,WE,Federal Contract Tower,0,0,7,0,7,0,0,97,0,97,0,0,104,0,104,178,0,178,282
03/21/2021,WHP,CA,AWP,WE,Federal Contract Tower,0,0,0,0,0,0,0,63,0,63,0,0,63,0,63,80,0,80,143
03/22/2021,WHP,CA,AWP,WE,Federal Contract Tower,0,0,0,0,0,0,0,92,0,92,0,0,92,0,92,88,0,88,180
03/23/2021,WHP,CA,AWP,WE,Federal Contract Tower,0,0,1,0,1,0,0,39,0,39,0,0,40,0,40,22,0,22,62
03/24/2021,WHP,CA,AWP,WE,Federal Contract Tower,0,0,0,0,0,0,0,71,0,71,0,0,71,0,71,36,0,36,107
03/25/2021,WHP,CA,AWP,WE,Federal Contract Tower,0,0,1,0,1,0,0,81,0,81,0,0,82,0,82,122,0,122,204
03/26/2021,WHP,CA,AWP,WE,Federal Contract Tower,0,0,0,0,0,0,0,59,0,59,0,0,59,0,59,112,0,112,171
03/27/2021,WHP,CA,AWP,WE,Federal Contract Tower,0,0,7,0,7,0,0,207,0,207,0,0,214,0,214,240,0,240,454
03/28/2021,WHP,CA,AWP,WE,Federal Contract Tower,0,0,0,0,0,0,0,216,0,216,0,0,216,0,216,262,0,262,478
03/29/2021,WHP,CA,AWP,WE,Federal Contract Tower,0,0,0,0,0,0,0,175,0,175,0,0,175,0,175,198,0,198,373
03/30/2021,WHP,CA,AWP,WE,Federal Contract Tower,0,0,3,0,3,0,0,127,0,127,0,0,130,0,130,254,0,254,384
03/31/2021,WHP,CA,AWP,WE,Federal Contract Tower,0,0,0,0,0,0,0,95,0,95,0,0,95,0,95,154,0,154,249
04/01/2021,WHP,CA,AWP,WE,Federal Contract Tower,0,0,0,0,0,0,0,155,0,155,0,0,155,0,155,298,0,298,453
04/02/2021,WHP,CA,AWP,WE,Federal Contract Tower,0,0,6,0,6,0,0,171,0,171,0,0,177,0,177,296,0,296,473
04/03/2021,WHP,CA,AWP,WE,Federal Contract Tower,0,0,4,0,4,0,0,211,0,211,0,0,215,0,215,402,0,402,617
04/04/2021,WHP,CA,AWP,WE,Federal Contract Tower,0,0,1,0,1,0,0,200,0,200,0,0,201,0,201,278,0,278,479
04/05/2021,WHP,CA,AWP,WE,Federal Contract Tower,0,0,0,0,0,0,0,156,0,156,0,0,156,0,156,190,0,190,346
04/06/2021,WHP,CA,AWP,WE,Federal Contract Tower,0,0,2,0,2,0,0,161,0,161,0,0,163,0,163,308,0,308,471
04/07/2021,WHP,CA,AWP,WE,Federal Contract Tower,0,0,2,0,2,0,0,155,0,155,0,0,157,0,157,390,0,390,547
04/08/2021,WHP,CA,AWP,WE,Federal Contract Tower,0,0,0,0,0,0,0,104,0,104,0,0,104,0,104,144,0,144,248
04/09/2021,WHP,CA,AWP,WE,Federal Contract Tower,0,0,0,0,0,0,0,171,0,171,0,0,171,0,171,238,0,238,409
04/10/2021,WHP,CA,AWP,WE,Federal Contract Tower,0,0,0,0,0,0,0,174,0,174,0,0,174,0,174,258,0,258,432
04/11/2021,WHP,CA,AWP,WE,Federal Contract Tower,0,0,0,0,0,0,0,172,0,172,0,0,172,0,172,228,0,228,400
04/12/2021,WHP,CA,AWP,WE,Federal Contract Tower,0,0,17,0,17,0,0,75,0,75,0,0,92,0,92,92,0,92,184
04/13/2021,WHP,CA,AWP,WE,Federal Contract Tower,0,0,1,0,1,0,0,63,0,63,0,0,64,0,64,10,0,10,74
04/14/2021,WHP,CA,AWP,WE,Federal Contract Tower,0,0,7,0,7,0,0,77,0,77,0,0,84,0,84,122,0,122,206
04/15/2021,WHP,CA,AWP,WE,Federal Contract Tower,0,0,0,0,0,0,0,99,0,99,0,0,99,0,99,96,0,96,195
04/16/2021,WHP,CA,AWP,WE,Federal Contract Tower,0,0,0,0,0,0,0,125,0,125,0,0,125,0,125,244,0,244,369
04/17/2021,WHP,CA,AWP,WE,Federal Contract Tower,0,0,1,0,1,0,0,195,0,195,0,0,196,0,196,302,0,302,498
04/18/2021,WHP,CA,AWP,WE,Federal Contract Tower,0,0,1,0,1,0,0,10,0,10,0,0,11,0,11,20,0,20,31
04/19/2021,WHP,CA,AWP,WE,Federal Contract Tower,0,0,6,0,6,0,0,101,0,101,0,0,107,0,107,218,0,218,325
04/20/2021,WHP,CA,AWP,WE,Federal Contract Tower,0,0,0,0,0,0,0,132,0,132,0,0,132,0,132,322,0,322,454
04/21/2021,WHP,CA,AWP,WE,Federal Contract Tower,0,0,6,0,6,0,0,85,0,85,0,0,91,0,91,122,0,122,213
04/22/2021,WHP,CA,AWP,WE,Federal Contract Tower,0,0,7,0,7,0,0,34,0,34,0,0,41,0,41,115,0,115,156
04/23/2021,WHP,CA,AWP,WE,Federal Contract Tower,0,0,7,0,7,0,0,115,0,115,0,0,122,0,122,230,0,230,352
04/24/2021,WHP,CA,AWP,WE,Federal Contract Tower,0,0,7,0,7,0,0,190,0,190,0,0,197,0,197,462,0,462,659
04/25/2021,WHP,CA,AWP,WE,Federal Contract Tower,0,0,5,0,5,0,0,128,0,128,0,0,133,0,133,224,0,224,357
04/26/2021,WHP,CA,AWP,WE,Federal Contract Tower,0,0,0,0,0,0,0,78,0,78,0,0,78,0,78,196,0,196,274
04/27/2021,WHP,CA,AWP,WE,Federal Contract Tower,0,0,2,0,2,0,0,106,0,106,0,0,108,0,108,298,0,298,406
04/28/2021,WHP,CA,AWP,WE,Federal Contract Tower,0,0,5,0,5,0,0,45,0,45,0,0,50,0,50,42,0,42,92
04/29/2021,WHP,CA,AWP,WE,Federal Contract Tower,0,0,1,0,1,0,0,145,0,145,0,0,146,0,146,354,0,354,500
04/30/2021,WHP,CA,AWP,WE,Federal Contract Tower,0,0,1,0,1,0,0,142,0,142,0,0,143,0,143,222,0,222,365
05/01/2021,WHP,CA,AWP,WE,Federal Contract Tower,0,0,1,0,1,0,0,154,0,154,0,0,155,0,155,350,0,350,505
05/02/2021,WHP,CA,AWP,WE,Federal Contract Tower,0,0,0,0,0,0,0,140,0,140,0,0,140,0,140,326,0,326,466
05/03/2021,WHP,CA,AWP,WE,Federal Contract Tower,0,0,0,0,0,0,0,130,0,130,0,0,130,0,130,228,0,228,358
05/04/2021,WHP,CA,AWP,WE,Federal Contract Tower,0,0,4,0,4,0,0,90,0,90,0,0,94,0,94,262,0,262,356
05/05/2021,WHP,CA,AWP,WE,Federal Contract Tower,0,0,0,0,0,0,0,122,0,122,0,0,122,0,122,204,0,204,326
05/06/2021,WHP,CA,AWP,WE,Federal Contract Tower,0,0,5,0,5,0,0,123,0,123,0,0,128,0,128,330,0,330,458
05/07/2021,WHP,CA,AWP,WE,Federal Contract Tower,0,0,6,0,6,0,0,130,0,130,0,0,136,0,136,218,0,218,354
05/08/2021,WHP,CA,AWP,WE,Federal Contract Tower,0,0,0,0,0,0,0,172,0,172,0,0,172,0,172,394,0,394,566
05/09/2021,WHP,CA,AWP,WE,Federal Contract Tower,0,0,5,0,5,0,0,136,0,136,0,0,141,0,141,220,0,220,361
05/10/2021,WHP,CA,AWP,WE,Federal Contract Tower,0,0,25,0,25,0,0,66,0,66,0,0,91,0,91,258,0,258,349
05/11/2021,WHP,CA,AWP,WE,Federal Contract Tower,0,0,5,0,5,0,0,99,0,99,0,0,104,0,104,352,0,352,456
05/12/2021,WHP,CA,AWP,WE,Federal Contract Tower,0,0,1,0,1,0,0,104,0,104,0,0,105,0,105,186,0,186,291
05/13/2021,WHP,CA,AWP,WE,Federal Contract Tower,0,0,2,0,2,0,0,149,0,149,0,0,151,0,151,304,0,304,455
05/14/2021,WHP,CA,AWP,WE,Federal Contract Tower,0,0,4,0,4,0,0,104,0,104,0,0,108,0,108,266,0,266,374
05/15/2021,WHP,CA,AWP,WE,Federal Contract Tower,0,0,2,0,2,0,0,92,0,92,0,0,94,0,94,182,0,182,276
05/16/2021,WHP,CA,AWP,WE,Federal Contract Tower,0,0,28,0,28,0,0,70,0,70,0,0,98,0,98,150,0,150,248
05/17/2021,WHP,CA,AWP,WE,Federal Contract Tower,0,0,12,0,12,0,0,116,0,116,0,0,128,0,128,216,0,216,344
05/18/2021,WHP,CA,AWP,WE,Federal Contract Tower,0,0,3,0,3,0,0,91,0,91,0,0,94,0,94,250,0,250,344
05/19/2021,WHP,CA,AWP,WE,Federal Contract Tower,0,0,6,0,6,0,0,125,0,125,0,0,131,0,131,242,0,242,373
05/20/2021,WHP,CA,AWP,WE,Federal Contract Tower,0,0,4,0,4,0,0,113,0,113,0,0,117,0,117,130,0,130,247
05/21/2021,WHP,CA,AWP,WE,Federal Contract Tower,0,0,2,0,2,0,0,67,0,67,0,0,69,0,69,68,0,68,137
05/22/2021,WHP,CA,AWP,WE,Federal Contract Tower,0,0,4,0,4,0,0,182,0,182,0,0,186,0,186,214,0,214,400
05/24/2021,WHP,CA,AWP,WE,Federal Contract Tower,0,0,1,0,1,0,0,166,0,166,0,0,167,0,167,178,0,178,345
05/25/2021,WHP,CA,AWP,WE,Federal Contract Tower,0,0,0,0,0,0,0,108,0,108,0,0,108,0,108,102,0,102,210
05/26/2021,WHP,CA,AWP,WE,Federal Contract Tower,0,0,0,0,0,0,0,157,0,157,0,0,157,0,157,354,0,354,511
05/27/2021,WHP,CA,AWP,WE,Federal Contract Tower,0,0,0,0,0,0,0,116,0,116,0,0,116,0,116,164,0,164,280
05/28/2021,WHP,CA,AWP,WE,Federal Contract Tower,0,0,3,0,3,0,0,132,0,132,0,0,135,0,135,106,0,106,241
05/29/2021,WHP,CA,AWP,WE,Federal Contract Tower,0,0,16,0,16,0,0,100,0,100,0,0,116,0,116,142,0,142,258
05/30/2021,WHP,CA,AWP,WE,Federal Contract Tower,0,0,1,0,1,0,0,138,0,138,0,0,139,0,139,204,0,204,343
05/31/2021,WHP,CA,AWP,WE,Federal Contract Tower,0,0,13,0,13,0,0,174,0,174,0,0,187,0,187,216,0,216,403
06/01/2021,WHP,CA,AWP,WE,Federal Contract Tower,0,0,0,0,0,0,0,160,0,160,0,0,160,0,160,250,0,250,410
06/02/2021,WHP,CA,AWP,WE,Federal Contract Tower,0,0,4,0,4,0,0,147,0,147,0,0,151,0,151,310,0,310,461
06/03/2021,WHP,CA,AWP,WE,Federal Contract Tower,0,0,0,0,0,0,0,177,0,177,0,0,177,0,177,290,0,290,467
06/04/2021,WHP,CA,AWP,WE,Federal Contract Tower,0,0,0,0,0,0,0,199,0,199,0,0,199,0,199,256,0,256,455
06/05/2021,WHP,CA,AWP,WE,Federal Contract Tower,0,0,8,0,8,0,0,243,0,243,0,0,251,0,251,316,0,316,567
06/06/2021,WHP,CA,AWP,WE,Federal Contract Tower,0,0,5,0,5,0,0,152,0,152,0,0,157,0,157,302,0,302,459
06/07/2021,WHP,CA,AWP,WE,Federal Contract Tower,0,0,14,0,14,0,0,52,0,52,0,0,66,0,66,120,0,120,186
06/08/2021,WHP,CA,AWP,WE,Federal Contract Tower,0,0,6,0,6,0,0,114,0,114,0,0,120,0,120,250,0,250,370
06/09/2021,WHP,CA,AWP,WE,Federal Contract Tower,0,0,0,0,0,0,0,110,0,110,0,0,110,0,110,144,0,144,254
06/10/2021,WHP,CA,AWP,WE,Federal Contract Tower,0,0,0,0,0,0,0,97,0,97,0,0,97,0,97,116,0,116,213
06/11/2021,WHP,CA,AWP,WE,Federal Contract Tower,0,0,0,0,0,0,0,203,0,203,0,0,203,0,203,274,0,274,477
06/12/2021,WHP,CA,AWP,WE,Federal Contract Tower,0,0,1,0,1,0,0,202,0,202,0,0,203,0,203,354,0,354,557
06/13/2021,WHP,CA,AWP,WE,Federal Contract Tower,0,0,2,0,2,0,0,192,0,192,0,0,194,0,194,238,0,238,432
06/14/2021,WHP,CA,AWP,WE,Federal Contract Tower,0,0,0,0,0,0,0,206,0,206,0,0,206,0,206,326,0,326,532
06/15/2021,WHP,CA,AWP,WE,Federal Contract Tower,0,0,3,0,3,0,0,107,0,107,0,0,110,0,110,132,0,132,242
06/16/2021,WHP,CA,AWP,WE,Federal Contract Tower,0,0,0,0,0,0,0,114,0,114,0,0,114,0,114,160,0,160,274
06/17/2021,WHP,CA,AWP,WE,Federal Contract Tower,0,0,0,0,0,0,0,115,0,115,0,0,115,0,115,162,0,162,277
06/18/2021,WHP,CA,AWP,WE,Federal Contract Tower,0,0,1,0,1,0,0,206,0,206,0,0,207,0,207,368,0,368,575
06/19/2021,WHP,CA,AWP,WE,Federal Contract Tower,0,0,2,0,2,0,0,165,0,165,0,0,167,0,167,256,0,256,423
06/20/2021,WHP,CA,AWP,WE,Federal Contract Tower,0,0,5,0,5,0,0,162,0,162,0,0,167,0,167,248,0,248,415
06/21/2021,WHP,CA,AWP,WE,Federal Contract Tower,0,0,4,0,4,0,0,132,0,132,0,0,136,0,136,190,0,190,326
06/22/2021,WHP,CA,AWP,WE,Federal Contract Tower,0,0,0,0,0,0,0,115,0,115,0,0,115,0,115,188,0,188,303
06/23/2021,WHP,CA,AWP,WE,Federal Contract Tower,0,0,0,0,0,0,0,113,0,113,0,0,113,0,113,186,0,186,299
06/24/2021,WHP,CA,AWP,WE,Federal Contract Tower,0,0,0,0,0,0,0,138,0,138,0,0,138,0,138,266,0,266,404
06/25/2021,WHP,CA,AWP,WE,Federal Contract Tower,0,0,0,0,0,0,0,167,0,167,0,0,167,0,167,86,0,86,253
06/26/2021,WHP,CA,AWP,WE,Federal Contract Tower,0,0,0,0,0,0,0,259,0,259,0,0,259,0,259,140,0,140,399
06/27/2021,WHP,CA,AWP,WE,Federal Contract Tower,0,0,0,0,0,0,0,188,0,188,0,0,188,0,188,208,0,208,396
06/28/2021,WHP,CA,AWP,WE,Federal Contract Tower,0,0,0,0,0,0,0,96,0,96,0,0,96,0,96,150,0,150,246
06/29/2021,WHP,CA,AWP,WE,Federal Contract Tower,0,0,2,0,2,0,0,77,0,77,0,0,79,0,79,90,0,90,169
06/30/2021,WHP,CA,AWP,WE,Federal Contract Tower,0,0,4,0,4,0,0,108,0,108,0,0,112,0,112,162,0,162,274
07/01/2021,WHP,CA,AWP,WE,Federal Contract Tower,0,0,3,0,3,0,0,132,0,132,0,0,135,0,135,152,0,152,287
07/02/2021,WHP,CA,AWP,WE,Federal Contract Tower,0,0,2,0,2,0,0,133,0,133,0,0,135,0,135,88,0,88,223
07/03/2021,WHP,CA,AWP,WE,Federal Contract Tower,0,0,1,0,1,0,0,150,0,150,0,0,151,0,151,264,0,264,415
07/04/2021,WHP,CA,AWP,WE,Federal Contract Tower,0,0,0,0,0,0,0,114,0,114,0,0,114,0,114,160,0,160,274
07/05/2021,WHP,CA,AWP,WE,Federal Contract Tower,0,0,2,0,2,0,0,120,0,120,0,0,122,0,122,164,0,164,286
07/06/2021,WHP,CA,AWP,WE,Federal Contract Tower,0,0,0,0,0,0,0,111,0,111,0,0,111,0,111,160,0,160,271
07/07/2021,WHP,CA,AWP,WE,Federal Contract Tower,0,0,0,0,0,0,0,117,0,117,0,0,117,0,117,194,0,194,311
07/08/2021,WHP,CA,AWP,WE,Federal Contract Tower,0,0,1,0,1,0,0,128,0,128,0,0,129,0,129,176,0,176,305
07/09/2021,WHP,CA,AWP,WE,Federal Contract Tower,0,0,0,0,0,0,0,147,0,147,0,0,147,0,147,172,0,172,319
07/10/2021,WHP,CA,AWP,WE,Federal Contract Tower,0,0,0,0,0,0,0,195,0,195,0,0,195,0,195,214,0,214,409
07/11/2021,WHP,CA,AWP,WE,Federal Contract Tower,0,0,0,0,0,0,0,166,0,166,0,0,166,0,166,156,0,156,322
07/12/2021,WHP,CA,AWP,WE,Federal Contract Tower,0,0,1,0,1,0,0,136,0,136,0,0,137,0,137,192,0,192,329
07/13/2021,WHP,CA,AWP,WE,Federal Contract Tower,0,0,0,0,0,0,0,114,0,114,0,0,114,0,114,228,0,228,342
07/14/2021,WHP,CA,AWP,WE,Federal Contract Tower,0,0,3,0,3,0,0,14,0,14,0,0,17,0,17,298,0,298,315
07/15/2021,WHP,CA,AWP,WE,Federal Contract Tower,0,0,1,0,1,0,0,119,0,119,0,0,120,0,120,94,0,94,214
07/16/2021,WHP,CA,AWP,WE,Federal Contract Tower,0,0,2,0,2,0,0,187,0,187,0,0,189,0,189,240,0,240,429
07/17/2021,WHP,CA,AWP,WE,Federal Contract Tower,0,0,0,0,0,0,0,177,0,177,0,0,177,0,177,182,0,182,359
07/18/2021,WHP,CA,AWP,WE,Federal Contract Tower,0,0,0,0,0,0,0,202,0,202,0,0,202,0,202,212,0,212,414
07/19/2021,WHP,CA,AWP,WE,Federal Contract Tower,0,0,4,0,4,0,0,178,0,178,0,0,182,0,182,250,0,250,432
07/20/2021,WHP,CA,AWP,WE,Federal Contract Tower,0,0,1,0,1,0,0,95,0,95,0,0,96,0,96,134,0,134,230
07/21/2021,WHP,CA,AWP,WE,Federal Contract Tower,0,0,0,0,0,0,0,85,0,85,0,0,85,0,85,150,0,150,235
07/22/2021,WHP,CA,AWP,WE,Federal Contract Tower,0,0,0,0,0,0,0,111,0,111,0,0,111,0,111,168,0,168,279
07/23/2021,WHP,CA,AWP,WE,Federal Contract Tower,0,0,0,0,0,0,0,204,0,204,0,0,204,0,204,202,0,202,406
07/24/2021,WHP,CA,AWP,WE,Federal Contract Tower,0,0,0,0,0,0,0,236,0,236,0,0,236,0,236,272,0,272,508
07/25/2021,WHP,CA,AWP,WE,Federal Contract Tower,0,0,0,0,0,0,0,168,0,168,0,0,168,0,168,106,0,106,274
07/26/2021,WHP,CA,AWP,WE,Federal Contract Tower,0,0,0,0,0,0,0,98,0,98,0,0,98,0,98,164,0,164,262
07/27/2021,WHP,CA,AWP,WE,Federal Contract Tower,0,0,4,0,4,0,0,85,0,85,0,0,89,0,89,84,0,84,173
07/28/2021,WHP,CA,AWP,WE,Federal Contract Tower,0,0,0,0,0,0,0,194,0,194,0,0,194,0,194,278,0,278,472
07/29/2021,WHP,CA,AWP,WE,Federal Contract Tower,0,0,1,0,1,0,0,120,0,120,0,0,121,0,121,202,0,202,323
07/30/2021,WHP,CA,AWP,WE,Federal Contract Tower,0,0,0,0,0,0,0,169,0,169,0,0,169,0,169,236,0,236,405
07/31/2021,WHP,CA,AWP,WE,Federal Contract Tower,0,0,1,0,1,0,0,178,0,178,0,0,179,0,179,244,0,244,423
08/01/2021,WHP,CA,AWP,WE,Federal Contract Tower,0,0,0,0,0,0,0,177,0,177,0,0,177,0,177,164,0,164,341
08/02/2021,WHP,CA,AWP,WE,Federal Contract Tower,0,0,0,0,0,0,0,145,0,145,0,0,145,0,145,140,0,140,285
08/03/2021,WHP,CA,AWP,WE,Federal Contract Tower,0,0,0,0,0,0,0,131,0,131,0,0,131,0,131,130,0,130,261
08/04/2021,WHP,CA,AWP,WE,Federal Contract Tower,0,0,0,0,0,0,0,100,0,100,0,0,100,0,100,166,0,166,266
08/05/2021,WHP,CA,AWP,WE,Federal Contract Tower,0,0,0,0,0,0,0,136,0,136,0,0,136,0,136,132,0,132,268
08/06/2021,WHP,CA,AWP,WE,Federal Contract Tower,0,0,0,0,0,0,0,197,0,197,0,0,197,0,197,206,0,206,403
08/07/2021,WHP,CA,AWP,WE,Federal Contract Tower,0,0,2,0,2,0,0,157,0,157,0,0,159,0,159,246,0,246,405
08/08/2021,WHP,CA,AWP,WE,Federal Contract Tower,0,0,1,0,1,0,0,176,0,176,0,0,177,0,177,170,0,170,347
08/09/2021,WHP,CA,AWP,WE,Federal Contract Tower,0,0,0,0,0,0,0,190,0,190,0,0,190,0,190,194,0,194,384
08/10/2021,WHP,CA,AWP,WE,Federal Contract Tower,0,0,1,0,1,0,0,75,0,75,0,0,76,0,76,116,0,116,192
08/11/2021,WHP,CA,AWP,WE,Federal Contract Tower,0,0,2,0,2,0,0,121,0,121,0,0,123,0,123,208,0,208,331
08/12/2021,WHP,CA,AWP,WE,Federal Contract Tower,0,0,0,0,0,0,0,121,0,121,0,0,121,0,121,122,0,122,243
08/13/2021,WHP,CA,AWP,WE,Federal Contract Tower,0,0,0,0,0,0,0,169,0,169,0,0,169,0,169,244,0,244,413
08/14/2021,WHP,CA,AWP,WE,Federal Contract Tower,0,0,0,0,0,0,0,170,0,170,0,0,170,0,170,236,0,236,406
08/15/2021,WHP,CA,AWP,WE,Federal Contract Tower,0,0,1,0,1,0,0,192,0,192,0,0,193,0,193,180,0,180,373
08/16/2021,WHP,CA,AWP,WE,Federal Contract Tower,0,0,0,0,0,0,0,148,0,148,0,0,148,0,148,202,0,202,350
08/17/2021,WHP,CA,AWP,WE,Federal Contract Tower,0,0,0,0,0,0,0,103,0,103,0,0,103,0,103,176,0,176,279
08/18/2021,WHP,CA,AWP,WE,Federal Contract Tower,0,0,2,0,2,0,0,24,0,24,0,0,26,0,26,44,0,44,70
08/19/2021,WHP,CA,AWP,WE,Federal Contract Tower,0,0,2,0,2,0,0,154,0,154,0,0,156,0,156,296,0,296,452
08/20/2021,WHP,CA,AWP,WE,Federal Contract Tower,0,0,1,0,1,0,0,146,0,146,0,0,147,0,147,180,0,180,327
08/21/2021,WHP,CA,AWP,WE,Federal Contract Tower,0,0,0,0,0,0,0,102,0,102,0,0,102,0,102,184,0,184,286
08/22/2021,WHP,CA,AWP,WE,Federal Contract Tower,0,0,4,0,4,0,0,208,0,208,0,0,212,0,212,280,0,280,492
08/23/2021,WHP,CA,AWP,WE,Federal Contract Tower,0,0,2,0,2,0,0,0,0,0,0,0,2,0,2,358,0,358,360
08/24/2021,WHP,CA,AWP,WE,Federal Contract Tower,0,0,1,0,1,0,0,146,0,146,0,0,147,0,147,324,0,324,471
08/25/2021,WHP,CA,AWP,WE,Federal Contract Tower,0,0,0,0,0,0,0,156,0,156,0,0,156,0,156,286,0,286,442
08/26/2021,WHP,CA,AWP,WE,Federal Contract Tower,0,0,0,0,0,0,0,171,0,171,0,0,171,0,171,146,0,146,317
08/27/2021,WHP,CA,AWP,WE,Federal Contract Tower,0,0,2,0,2,0,0,113,0,113,0,0,115,0,115,84,0,84,199
08/28/2021,WHP,CA,AWP,WE,Federal Contract Tower,0,0,0,0,0,0,0,217,0,217,0,0,217,0,217,172,0,172,389
08/29/2021,WHP,CA,AWP,WE,Federal Contract Tower,0,0,0,0,0,0,0,174,0,174,0,0,174,0,174,198,0,198,372
08/30/2021,WHP,CA,AWP,WE,Federal Contract Tower,0,0,2,0,2,0,0,132,0,132,0,0,134,0,134,202,0,202,336
08/31/2021,WHP,CA,AWP,WE,Federal Contract Tower,0,0,1,0,1,0,0,61,0,61,0,0,62,0,62,198,0,198,260
09/01/2021,WHP,CA,AWP,WE,Federal Contract Tower,0,0,12,0,12,0,0,98,0,98,0,0,110,0,110,132,0,132,242
09/02/2021,WHP,CA,AWP,WE,Federal Contract Tower,0,0,4,0,4,0,0,104,0,104,0,0,108,0,108,208,0,208,316
09/03/2021,WHP,CA,AWP,WE,Federal Contract Tower,0,0,0,0,0,0,0,153,0,153,0,0,153,0,153,154,0,154,307
09/04/2021,WHP,CA,AWP,WE,Federal Contract Tower,0,0,0,0,0,0,0,173,0,173,0,0,173,0,173,220,0,220,393
09/05/2021,WHP,CA,AWP,WE,Federal Contract Tower,0,0,0,0,0,0,0,188,0,188,0,0,188,0,188,234,0,234,422
09/06/2021,WHP,CA,AWP,WE,Federal Contract Tower,0,0,4,0,4,0,0,122,0,122,0,0,126,0,126,90,0,90,216
09/07/2021,WHP,CA,AWP,WE,Federal Contract Tower,0,0,0,0,0,0,0,111,0,111,0,0,111,0,111,328,0,328,439
09/08/2021,WHP,CA,AWP,WE,Federal Contract Tower,0,0,0,0,0,0,0,142,0,142,0,0,142,0,142,188,0,188,330
09/09/2021,WHP,CA,AWP,WE,Federal Contract Tower,0,0,0,0,0,0,0,131,0,131,0,0,131,0,131,230,0,230,361
09/10/2021,WHP,CA,AWP,WE,Federal Contract Tower,0,0,0,0,0,0,0,167,0,167,0,0,167,0,167,318,0,318,485
09/11/2021,WHP,CA,AWP,WE,Federal Contract Tower,0,0,0,0,0,0,0,156,0,156,0,0,156,0,156,240,0,240,396
09/12/2021,WHP,CA,AWP,WE,Federal Contract Tower,0,0,2,0,2,0,0,222,0,222,0,0,224,0,224,284,0,284,508
09/13/2021,WHP,CA,AWP,WE,Federal Contract Tower,0,0,1,0,1,0,0,100,0,100,0,0,101,0,101,162,0,162,263
09/14/2021,WHP,CA,AWP,WE,Federal Contract Tower,0,0,0,0,0,0,0,79,0,79,0,0,79,0,79,136,0,136,215
09/15/2021,WHP,CA,AWP,WE,Federal Contract Tower,0,0,3,0,3,0,0,93,0,93,0,0,96,0,96,158,0,158,254
09/16/2021,WHP,CA,AWP,WE,Federal Contract Tower,0,0,1,0,1,0,0,105,0,105,0,0,106,0,106,204,0,204,310
09/17/2021,WHP,CA,AWP,WE,Federal Contract Tower,0,0,0,0,0,0,0,132,0,132,0,0,132,0,132,176,0,176,308
09/18/2021,WHP,CA,AWP,WE,Federal Contract Tower,0,0,1,0,1,0,0,224,0,224,0,0,225,0,225,296,0,296,521
09/19/2021,WHP,CA,AWP,WE,Federal Contract Tower,0,0,11,0,11,0,0,158,0,158,0,0,169,0,169,202,0,202,371
09/20/2021,WHP,CA,AWP,WE,Federal Contract Tower,0,0,3,0,3,0,0,176,0,176,0,0,179,0,179,232,0,232,411
09/21/2021,WHP,CA,AWP,WE,Federal Contract Tower,0,0,0,0,0,0,0,96,0,96,0,0,96,0,96,152,0,152,248
09/22/2021,WHP,CA,AWP,WE,Federal Contract Tower,0,0,2,0,2,0,0,110,0,110,0,0,112,0,112,130,0,130,242
09/24/2021,WHP,CA,AWP,WE,Federal Contract Tower,0,0,2,0,2,0,0,137,0,137,0,0,139,0,139,200,0,200,339
09/25/2021,WHP,CA,AWP,WE,Federal Contract Tower,0,0,0,0,0,0,0,262,0,262,0,0,262,0,262,242,0,242,504
09/26/2021,WHP,CA,AWP,WE,Federal Contract Tower,0,0,5,0,5,0,0,157,0,157,0,0,162,0,162,258,0,258,420
09/27/2021,WHP,CA,AWP,WE,Federal Contract Tower,0,0,4,0,4,0,0,45,0,45,0,0,49,0,49,76,0,76,125
09/28/2021,WHP,CA,AWP,WE,Federal Contract Tower,0,0,19,0,19,0,0,57,0,57,0,0,76,0,76,130,0,130,206
09/29/2021,WHP,CA,AWP,WE,Federal Contract Tower,0,0,5,0,5,0,0,115,0,115,0,0,120,0,120,166,0,166,286
09/30/2021,WHP,CA,AWP,WE,Federal Contract Tower,0,0,2,0,2,0,0,144,0,144,0,0,146,0,146,150,0,150,296
10/01/2021,WHP,CA,AWP,WE,Federal Contract Tower,0,0,0,0,0,0,0,123,0,123,0,0,123,0,123,136,0,136,259
10/02/2021,WHP,CA,AWP,WE,Federal Contract Tower,0,0,0,0,0,0,0,196,0,196,0,0,196,0,196,302,0,302,498
10/03/2021,WHP,CA,AWP,WE,Federal Contract Tower,0,0,0,0,0,0,0,272,0,272,0,0,272,0,272,246,0,246,518
10/04/2021,WHP,CA,AWP,WE,Federal Contract Tower,0,0,2,0,2,0,0,164,0,164,0,0,166,0,166,196,0,196,362
10/05/2021,WHP,CA,AWP,WE,Federal Contract Tower,0,0,3,0,3,0,0,110,0,110,0,0,113,0,113,146,0,146,259
10/06/2021,WHP,CA,AWP,WE,Federal Contract Tower,0,0,0,0,0,0,0,103,0,103,0,0,103,0,103,126,0,126,229
10/07/2021,WHP,CA,AWP,WE,Federal Contract Tower,0,0,3,0,3,0,0,49,0,49,0,0,52,0,52,108,0,108,160
10/08/2021,WHP,CA,AWP,WE,Federal Contract Tower,0,0,2,0,2,0,0,113,0,113,0,0,115,0,115,208,0,208,323
10/09/2021,WHP,CA,AWP,WE,Federal Contract Tower,0,0,3,0,3,0,0,162,0,162,0,0,165,0,165,156,0,156,321
10/10/2021,WHP,CA,AWP,WE,Federal Contract Tower,0,0,0,0,0,0,0,240,0,240,0,0,240,0,240,280,0,280,520
10/11/2021,WHP,CA,AWP,WE,Federal Contract Tower,0,0,0,0,0,0,0,78,0,78,0,0,78,0,78,128,0,128,206
10/12/2021,WHP,CA,AWP,WE,Federal Contract Tower,0,0,0,0,0,0,0,53,0,53,0,0,53,0,53,48,0,48,101
10/13/2021,WHP,CA,AWP,WE,Federal Contract Tower,0,0,1,0,1,0,0,112,0,112,0,0,113,0,113,124,0,124,237
10/14/2021,WHP,CA,AWP,WE,Federal Contract Tower,0,0,5,0,5,0,0,153,0,153,0,0,158,0,158,178,0,178,336
10/15/2021,WHP,CA,AWP,WE,Federal Contract Tower,0,0,0,0,0,0,0,145,0,145,0,0,145,0,145,140,0,140,285
10/16/2021,WHP,CA,AWP,WE,Federal Contract Tower,0,0,0,0,0,0,0,150,0,150,0,0,150,0,150,180,0,180,330
10/17/2021,WHP,CA,AWP,WE,Federal Contract Tower,0,0,3,0,3,0,0,226,0,226,0,0,229,0,229,314,0,314,543
10/18/2021,WHP,CA,AWP,WE,Federal Contract Tower,0,0,2,0,2,0,0,76,0,76,0,0,78,0,78,94,0,94,172
10/19/2021,WHP,CA,AWP,WE,Federal Contract Tower,0,0,0,0,0,0,0,106,0,106,0,0,106,0,106,110,0,110,216
10/20/2021,WHP,CA,AWP,WE,Federal Contract Tower,0,0,3,0,3,0,0,146,0,146,0,0,149,0,149,234,0,234,383
10/21/2021,WHP,CA,AWP,WE,Federal Contract Tower,0,0,8,0,8,0,0,200,0,200,0,0,208,0,208,266,0,266,474
10/22/2021,WHP,CA,AWP,WE,Federal Contract Tower,0,0,0,0,0,0,0,196,0,196,0,0,196,0,196,318,0,318,514
10/23/2021,WHP,CA,AWP,WE,Federal Contract Tower,0,0,8,0,8,0,0,107,0,107,0,0,115,0,115,354,0,354,469
10/24/2021,WHP,CA,AWP,WE,Federal Contract Tower,0,0,5,0,5,0,0,118,0,118,0,0,123,0,123,324,0,324,447
10/25/2021,WHP,CA,AWP,WE,Federal Contract Tower,0,0,2,0,2,0,0,4,0,4,0,0,6,0,6,0,0,0,6
10/26/2021,WHP,CA,AWP,WE,Federal Contract Tower,0,0,1,0,1,0,0,57,0,57,0,0,58,0,58,102,0,102,160
10/27/2021,WHP,CA,AWP,WE,Federal Contract Tower,0,0,3,0,3,0,0,121,0,121,0,0,124,0,124,202,0,202,326
10/28/2021,WHP,CA,AWP,WE,Federal Contract Tower,0,0,0,0,0,0,0,178,0,178,0,0,178,0,178,308,0,308,486
10/29/2021,WHP,CA,AWP,WE,Federal Contract Tower,0,0,1,0,1,0,0,179,0,179,0,0,180,0,180,248,0,248,428
10/30/2021,WHP,CA,AWP,WE,Federal Contract Tower,0,0,5,0,5,0,0,186,0,186,0,0,191,0,191,370,0,370,561
10/31/2021,WHP,CA,AWP,WE,Federal Contract Tower,0,0,10,0,10,0,0,80,0,80,0,0,90,0,90,178,0,178,268
11/01/2021,WHP,CA,AWP,WE,Federal Contract Tower,0,0,11,0,11,0,0,118,0,118,0,0,129,0,129,220,0,220,349
11/02/2021,WHP,CA,AWP,WE,Federal Contract Tower,0,0,1,0,1,0,0,79,0,79,0,0,80,0,80,172,0,172,252
11/03/2021,WHP,CA,AWP,WE,Federal Contract Tower,0,0,1,0,1,0,0,131,0,131,0,0,132,0,132,234,0,234,366
11/04/2021,WHP,CA,AWP,WE,Federal Contract Tower,0,0,3,0,3,0,0,131,0,131,0,0,134,0,134,250,0,250,384
11/05/2021,WHP,CA,AWP,WE,Federal Contract Tower,0,0,0,0,0,0,0,195,0,195,0,0,195,0,195,356,0,356,551
11/06/2021,WHP,CA,AWP,WE,Federal Contract Tower,0,0,3,0,3,0,0,143,0,143,0,0,146,0,146,288,0,288,434
11/07/2021,WHP,CA,AWP,WE,Federal Contract Tower,0,0,10,0,10,0,0,148,0,148,0,0,158,0,158,268,0,268,426
11/08/2021,WHP,CA,AWP,WE,Federal Contract Tower,0,0,0,0,0,0,0,134,0,134,0,0,134,0,134,286,0,286,420
11/09/2021,WHP,CA,AWP,WE,Federal Contract Tower,0,0,0,0,0,0,0,101,0,101,0,0,101,0,101,220,0,220,321
11/10/2021,WHP,CA,AWP,WE,Federal Contract Tower,0,0,2,0,2,0,0,146,0,146,0,0,148,0,148,178,0,178,326
11/11/2021,WHP,CA,AWP,WE,Federal Contract Tower,0,0,0,0,0,0,0,127,0,127,0,0,127,0,127,206,0,206,333
11/12/2021,WHP,CA,AWP,WE,Federal Contract Tower,0,0,0,0,0,0,0,106,0,106,0,0,106,0,106,70,0,70,176
11/13/2021,WHP,CA,AWP,WE,Federal Contract Tower,0,0,1,0,1,0,0,183,0,183,0,0,184,0,184,278,0,278,462
11/14/2021,WHP,CA,AWP,WE,Federal Contract Tower,0,0,8,0,8,0,0,1960,0,1960,0,0,1968,0,1968,294,0,294,2262
11/15/2021,WHP,CA,AWP,WE,Federal Contract Tower,0,0,4,0,4,0,0,168,0,168,0,0,172,0,172,278,0,278,450
11/16/2021,WHP,CA,AWP,WE,Federal Contract Tower,0,0,3,0,3,0,0,112,0,112,0,0,115,0,115,158,0,158,273
11/17/2021,WHP,CA,AWP,WE,Federal Contract Tower,0,0,3,0,3,0,0,132,0,132,0,0,135,0,135,232,0,232,367
11/18/2021,WHP,CA,AWP,WE,Federal Contract Tower,0,0,0,0,0,0,0,141,0,141,0,0,141,0,141,242,0,242,383
11/19/2021,WHP,CA,AWP,WE,Federal Contract Tower,0,0,0,0,0,0,0,111,0,111,0,0,111,0,111,236,0,236,347
11/20/2021,WHP,CA,AWP,WE,Federal Contract Tower,0,0,1,0,1,0,0,119,0,119,0,0,120,0,120,258,0,258,378
11/21/2021,WHP,CA,AWP,WE,Federal Contract Tower,0,0,0,0,0,0,0,33,0,33,0,0,33,0,33,18,0,18,51
11/22/2021,WHP,CA,AWP,WE,Federal Contract Tower,0,0,0,0,0,0,0,104,0,104,0,0,104,0,104,104,0,104,208
11/24/2021,WHP,CA,AWP,WE,Federal Contract Tower,0,0,1,1,2,0,0,101,0,101,0,0,102,1,103,114,0,114,217
11/25/2021,WHP,CA,AWP,WE,Federal Contract Tower,0,0,0,0,0,0,0,15,0,15,0,0,15,0,15,0,0,0,15
11/26/2021,WHP,CA,AWP,WE,Federal Contract Tower,0,0,2,0,2,0,0,129,0,129,0,0,131,0,131,172,0,172,303
11/27/2021,WHP,CA,AWP,WE,Federal Contract Tower,0,0,2,0,2,0,0,196,0,196,0,0,198,0,198,238,0,238,436
11/28/2021,WHP,CA,AWP,WE,Federal Contract Tower,0,0,1,0,1,0,0,174,0,174,0,0,175,0,175,342,0,342,517
11/29/2021,WHP,CA,AWP,WE,Federal Contract Tower,0,0,2,0,2,0,0,148,0,148,0,0,150,0,150,234,0,234,384
11/30/2021,WHP,CA,AWP,WE,Federal Contract Tower,0,0,0,0,0,0,0,85,0,85,0,0,85,0,85,128,0,128,213
12/01/2021,WHP,CA,AWP,WE,Federal Contract Tower,0,0,0,0,0,0,0,111,0,111,0,0,111,0,111,172,0,172,283
12/02/2021,WHP,CA,AWP,WE,Federal Contract Tower,0,0,1,0,1,0,0,60,0,60,0,0,61,0,61,178,0,178,239
12/03/2021,WHP,CA,AWP,WE,Federal Contract Tower,0,0,37,0,37,0,0,15,0,15,0,0,52,0,52,6,0,6,58
12/04/2021,WHP,CA,AWP,WE,Federal Contract Tower,0,0,26,0,26,0,0,33,0,33,0,0,59,0,59,90,0,90,149
12/05/2021,WHP,CA,AWP,WE,Federal Contract Tower,0,0,0,0,0,0,0,156,0,156,0,0,156,0,156,164,0,164,320
12/06/2021,WHP,CA,AWP,WE,Federal Contract Tower,0,0,2,0,2,0,0,108,0,108,0,0,110,0,110,174,0,174,284
12/07/2021,WHP,CA,AWP,WE,Federal Contract Tower,0,0,2,1,3,0,0,90,1,91,0,0,92,2,94,200,0,200,294
12/08/2021,WHP,CA,AWP,WE,Federal Contract Tower,0,0,3,0,3,0,0,152,0,152,0,0,155,0,155,196,0,196,351
12/09/2021,WHP,CA,AWP,WE,Federal Contract Tower,0,0,2,0,2,0,0,23,0,23,0,0,25,0,25,28,0,28,53
12/10/2021,WHP,CA,AWP,WE,Federal Contract Tower,0,0,0,0,0,0,0,132,0,132,0,0,132,0,132,188,0,188,320
12/11/2021,WHP,CA,AWP,WE,Federal Contract Tower,0,0,0,0,0,0,0,193,0,193,0,0,193,0,193,354,0,354,547
12/12/2021,WHP,CA,AWP,WE,Federal Contract Tower,0,0,0,0,0,0,0,190,0,190,0,0,190,0,190,268,0,268,458
12/13/2021,WHP,CA,AWP,WE,Federal Contract Tower,0,0,3,0,3,0,0,72,0,72,0,0,75,0,75,238,0,238,313
12/14/2021,WHP,CA,AWP,WE,Federal Contract Tower,0,0,2,0,2,0,0,14,0,14,0,0,16,0,16,0,0,0,16
12/15/2021,WHP,CA,AWP,WE,Federal Contract Tower,0,0,1,0,1,0,0,137,0,137,0,0,138,0,138,242,0,242,380
12/16/2021,WHP,CA,AWP,WE,Federal Contract Tower,0,0,0,0,0,0,0,49,0,49,0,0,49,0,49,112,0,112,161
12/17/2021,WHP,CA,AWP,WE,Federal Contract Tower,0,0,0,0,0,0,0,93,0,93,0,0,93,0,93,110,0,110,203
12/18/2021,WHP,CA,AWP,WE,Federal Contract Tower,0,0,0,0,0,0,0,147,0,147,0,0,147,0,147,198,0,198,345
12/19/2021,WHP,CA,AWP,WE,Federal Contract Tower,0,0,0,0,0,0,0,164,0,164,0,0,164,0,164,270,0,270,434
12/20/2021,WHP,CA,AWP,WE,Federal Contract Tower,0,0,0,0,0,0,0,172,0,172,0,0,172,0,172,334,0,334,506
12/21/2021,WHP,CA,AWP,WE,Federal Contract Tower,0,0,0,0,0,0,0,132,0,132,0,0,132,0,132,234,0,234,366
12/22/2021,WHP,CA,AWP,WE,Federal Contract Tower,0,0,1,0,1,0,0,145,0,145,0,0,146,0,146,324,0,324,470
12/23/2021,WHP,CA,AWP,WE,Federal Contract Tower,0,0,2,0,2,0,0,0,0,0,0,0,2,0,2,0,0,0,2
12/24/2021,WHP,CA,AWP,WE,Federal Contract Tower,0,0,0,0,0,0,0,23,0,23,0,0,23,0,23,0,0,0,23
12/25/2021,WHP,CA,AWP,WE,Federal Contract Tower,0,0,6,0,6,0,0,1,0,1,0,0,7,0,7,0,0,0,7
12/26/2021,WHP,CA,AWP,WE,Federal Contract Tower,0,0,0,0,0,0,0,108,0,108,0,0,108,0,108,146,0,146,254
12/27/2021,WHP,CA,AWP,WE,Federal Contract Tower,0,0,4,0,4,0,0,21,0,21,0,0,25,0,25,44,0,44,69
12/28/2021,WHP,CA,AWP,WE,Federal Contract Tower,0,0,5,0,5,0,0,117,0,117,0,0,122,0,122,314,0,314,436
12/30/2021,WHP,CA,AWP,WE,Federal Contract Tower,0,0,0,0,0,0,0,0,0,0,0,0,0,0,0,0,0,0,0
12/31/2021,WHP,CA,AWP,WE,Federal Contract Tower,0,0,0,0,0,0,0,86,0,86,0,0,86,0,86,0,0,0,86
01/01/2022,WHP,CA,AWP,WE,Federal Contract Tower,0,0,0,0,0,0,0,96,0,96,0,0,96,0,96,120,0,120,216
01/02/2022,WHP,CA,AWP,WE,Federal Contract Tower,0,0,0,0,0,0,0,125,0,125,0,0,125,0,125,266,0,266,391
01/03/2022,WHP,CA,AWP,WE,Federal Contract Tower,0,0,0,0,0,0,0,88,0,88,0,0,88,0,88,138,0,138,226
01/04/2022,WHP,CA,AWP,WE,Federal Contract Tower,0,0,0,0,0,0,0,84,0,84,0,0,84,0,84,176,0,176,260
01/05/2022,WHP,CA,AWP,WE,Federal Contract Tower,0,0,0,0,0,0,0,72,0,72,0,0,72,0,72,130,0,130,202
01/06/2022,WHP,CA,AWP,WE,Federal Contract Tower,0,0,0,0,0,0,0,125,0,125,0,0,125,0,125,242,0,242,367
01/07/2022,WHP,CA,AWP,WE,Federal Contract Tower,0,0,3,0,3,0,0,95,0,95,0,0,98,0,98,223,0,223,321
01/08/2022,WHP,CA,AWP,WE,Federal Contract Tower,0,0,1,0,1,0,0,123,0,123,0,0,124,0,124,306,0,306,430
01/09/2022,WHP,CA,AWP,WE,Federal Contract Tower,0,0,0,0,0,0,0,119,0,119,0,0,119,0,119,204,0,204,323
01/10/2022,WHP,CA,AWP,WE,Federal Contract Tower,0,0,1,0,1,0,0,42,0,42,0,0,43,0,43,56,0,56,99
01/11/2022,WHP,CA,AWP,WE,Federal Contract Tower,0,0,0,0,0,0,0,68,0,68,0,0,68,0,68,120,0,120,188
01/12/2022,WHP,CA,AWP,WE,Federal Contract Tower,0,0,1,0,1,0,0,132,0,132,0,0,133,0,133,230,0,230,363
01/13/2022,WHP,CA,AWP,WE,Federal Contract Tower,0,0,1,0,1,0,0,96,0,96,0,0,97,0,97,240,0,240,337
01/14/2022,WHP,CA,AWP,WE,Federal Contract Tower,0,0,0,0,0,0,0,87,0,87,0,0,87,0,87,96,0,96,183
01/15/2022,WHP,CA,AWP,WE,Federal Contract Tower,0,0,0,0,0,0,0,95,0,95,0,0,95,0,95,44,0,44,139
01/16/2022,WHP,CA,AWP,WE,Federal Contract Tower,0,0,1,0,1,0,0,159,0,159,0,0,160,0,160,180,0,180,340
01/17/2022,WHP,CA,AWP,WE,Federal Contract Tower,0,0,3,0,3,0,0,30,0,30,0,0,33,0,33,66,0,66,99
01/18/2022,WHP,CA,AWP,WE,Federal Contract Tower,0,0,2,0,2,0,0,92,0,92,0,0,94,0,94,268,0,268,362
01/19/2022,WHP,CA,AWP,WE,Federal Contract Tower,0,0,1,0,1,0,0,83,0,83,0,0,84,0,84,74,0,74,158
01/20/2022,WHP,CA,AWP,WE,Federal Contract Tower,0,0,0,0,0,0,0,98,0,98,0,0,98,0,98,214,0,214,312
01/21/2022,WHP,CA,AWP,WE,Federal Contract Tower,0,0,1,0,1,0,0,83,0,83,0,0,84,0,84,110,0,110,194
01/22/2022,WHP,CA,AWP,WE,Federal Contract Tower,0,0,1,0,1,0,0,33,0,33,0,0,34,0,34,0,0,0,34
01/23/2022,WHP,CA,AWP,WE,Federal Contract Tower,0,0,1,0,1,0,0,78,0,78,0,0,79,0,79,70,0,70,149
01/24/2022,WHP,CA,AWP,WE,Federal Contract Tower,0,0,1,0,1,0,0,126,0,126,0,0,127,0,127,84,0,84,211
01/25/2022,WHP,CA,AWP,WE,Federal Contract Tower,0,0,1,0,1,0,0,90,0,90,0,0,91,0,91,192,0,192,283
01/26/2022,WHP,CA,AWP,WE,Federal Contract Tower,0,0,1,0,1,0,0,128,0,128,0,0,129,0,129,126,0,126,255
01/27/2022,WHP,CA,AWP,WE,Federal Contract Tower,0,0,0,0,0,0,0,163,0,163,0,0,163,0,163,370,0,370,533
01/28/2022,WHP,CA,AWP,WE,Federal Contract Tower,0,0,2,0,2,0,0,50,0,50,0,0,52,0,52,54,0,54,106
01/29/2022,WHP,CA,AWP,WE,Federal Contract Tower,0,0,0,0,0,0,0,160,0,160,0,0,160,0,160,290,0,290,450
01/30/2022,WHP,CA,AWP,WE,Federal Contract Tower,0,0,2,0,2,0,0,195,0,195,0,0,197,0,197,226,0,226,423
01/31/2022,WHP,CA,AWP,WE,Federal Contract Tower,0,0,0,0,0,0,0,112,0,112,0,0,112,0,112,302,0,302,414
02/01/2022,WHP,CA,AWP,WE,Federal Contract Tower,0,0,0,0,0,0,0,69,0,69,0,0,69,0,69,142,0,142,211
02/02/2022,WHP,CA,AWP,WE,Federal Contract Tower,0,0,0,0,0,0,0,17,0,17,0,0,17,0,17,6,0,6,23
02/03/2022,WHP,CA,AWP,WE,Federal Contract Tower,0,0,0,0,0,0,0,93,0,93,0,0,93,0,93,154,0,154,247
02/04/2022,WHP,CA,AWP,WE,Federal Contract Tower,0,0,1,0,1,0,0,54,0,54,0,0,55,0,55,20,0,20,75
02/05/2022,WHP,CA,AWP,WE,Federal Contract Tower,0,0,2,0,2,0,0,152,0,152,0,0,154,0,154,266,0,266,420
02/06/2022,WHP,CA,AWP,WE,Federal Contract Tower,0,0,0,0,0,0,0,126,0,126,0,0,126,0,126,96,0,96,222
02/07/2022,WHP,CA,AWP,WE,Federal Contract Tower,0,0,0,0,0,0,0,81,0,81,0,0,81,0,81,180,0,180,261
02/08/2022,WHP,CA,AWP,WE,Federal Contract Tower,0,0,0,0,0,0,0,82,0,82,0,0,82,0,82,138,0,138,220
02/09/2022,WHP,CA,AWP,WE,Federal Contract Tower,0,0,1,0,1,0,0,52,0,52,0,0,53,0,53,42,0,42,95
02/10/2022,WHP,CA,AWP,WE,Federal Contract Tower,0,0,0,0,0,0,0,48,0,48,0,0,48,0,48,24,0,24,72
02/11/2022,WHP,CA,AWP,WE,Federal Contract Tower,0,0,0,0,0,0,0,165,0,165,0,0,165,0,165,278,0,278,443
02/12/2022,WHP,CA,AWP,WE,Federal Contract Tower,0,0,0,0,0,0,0,142,0,142,0,0,142,0,142,236,0,236,378
02/13/2022,WHP,CA,AWP,WE,Federal Contract Tower,0,0,1,0,1,0,0,54,0,54,0,0,55,0,55,184,0,184,239
02/14/2022,WHP,CA,AWP,WE,Federal Contract Tower,0,0,3,0,3,0,0,106,0,106,0,0,109,0,109,188,0,188,297
02/15/2022,WHP,CA,AWP,WE,Federal Contract Tower,0,0,0,0,0,0,0,23,0,23,0,0,23,0,23,10,0,10,33
02/16/2022,WHP,CA,AWP,WE,Federal Contract Tower,0,0,0,0,0,0,0,121,0,121,0,0,121,0,121,208,0,208,329
02/17/2022,WHP,CA,AWP,WE,Federal Contract Tower,0,0,0,0,0,0,0,48,0,48,0,0,48,0,48,44,0,44,92
02/18/2022,WHP,CA,AWP,WE,Federal Contract Tower,0,0,3,0,3,0,0,145,0,145,0,0,148,0,148,228,0,228,376
02/19/2022,WHP,CA,AWP,WE,Federal Contract Tower,0,0,0,0,0,0,0,187,0,187,0,0,187,0,187,240,0,240,427
02/20/2022,WHP,CA,AWP,WE,Federal Contract Tower,0,0,0,0,0,0,0,181,0,181,0,0,181,0,181,210,0,210,391
02/21/2022,WHP,CA,AWP,WE,Federal Contract Tower,0,0,0,0,0,0,0,47,0,47,0,0,47,0,47,82,0,82,129
02/22/2022,WHP,CA,AWP,WE,Federal Contract Tower,0,0,1,0,1,0,0,39,0,39,0,0,40,0,40,30,0,30,70
02/23/2022,WHP,CA,AWP,WE,Federal Contract Tower,0,0,0,0,0,0,0,42,0,42,0,0,42,0,42,40,0,40,82
02/24/2022,WHP,CA,AWP,WE,Federal Contract Tower,0,0,1,0,1,0,0,136,0,136,0,0,137,0,137,200,0,200,337
02/25/2022,WHP,CA,AWP,WE,Federal Contract Tower,0,0,4,0,4,0,0,172,0,172,0,0,176,0,176,300,0,300,476
02/26/2022,WHP,CA,AWP,WE,Federal Contract Tower,0,0,0,0,0,0,0,238,0,238,0,0,238,0,238,429,0,429,667
02/27/2022,WHP,CA,AWP,WE,Federal Contract Tower,0,0,0,0,0,0,0,138,0,138,0,0,138,0,138,220,0,220,358
02/28/2022,WHP,CA,AWP,WE,Federal Contract Tower,0,0,0,0,0,0,0,38,0,38,0,0,38,0,38,10,0,10,48
03/01/2022,WHP,CA,AWP,WE,Federal Contract Tower,0,0,0,0,0,0,0,105,0,105,0,0,105,0,105,238,0,238,343
03/02/2022,WHP,CA,AWP,WE,Federal Contract Tower,0,0,0,0,0,0,0,205,0,205,0,0,205,0,205,346,0,346,551
03/03/2022,WHP,CA,AWP,WE,Federal Contract Tower,0,0,0,0,0,0,0,118,0,118,0,0,118,0,118,292,0,292,410
03/04/2022,WHP,CA,AWP,WE,Federal Contract Tower,0,0,0,0,0,0,0,70,0,70,0,0,70,0,70,200,0,200,270
03/05/2022,WHP,CA,AWP,WE,Federal Contract Tower,0,0,0,0,0,0,0,71,0,71,0,0,71,0,71,124,0,124,195
03/06/2022,WHP,CA,AWP,WE,Federal Contract Tower,0,0,4,0,4,0,0,194,0,194,0,0,198,0,198,366,0,366,564
03/07/2022,WHP,CA,AWP,WE,Federal Contract Tower,0,0,1,0,1,0,0,37,0,37,0,0,38,0,38,22,0,22,60
03/08/2022,WHP,CA,AWP,WE,Federal Contract Tower,0,0,0,0,0,0,0,81,0,81,0,0,81,0,81,236,0,236,317
03/09/2022,WHP,CA,AWP,WE,Federal Contract Tower,0,0,0,0,0,0,0,189,0,189,0,0,189,0,189,404,0,404,593
03/10/2022,WHP,CA,AWP,WE,Federal Contract Tower,0,0,0,0,0,0,0,74,0,74,0,0,74,0,74,84,0,84,158
03/11/2022,WHP,CA,AWP,WE,Federal Contract Tower,0,0,0,0,0,0,0,140,0,140,0,0,140,0,140,408,0,408,548
03/12/2022,WHP,CA,AWP,WE,Federal Contract Tower,0,0,0,0,0,0,0,179,0,179,0,0,179,0,179,218,0,218,397
03/13/2022,WHP,CA,AWP,WE,Federal Contract Tower,0,0,0,0,0,0,0,113,0,113,0,0,113,0,113,214,0,214,327
03/14/2022,WHP,CA,AWP,WE,Federal Contract Tower,0,0,0,0,0,0,0,130,0,130,0,0,130,0,130,254,0,254,384
03/15/2022,WHP,CA,AWP,WE,Federal Contract Tower,0,0,2,0,2,0,0,160,0,160,0,0,162,0,162,510,0,510,672
03/16/2022,WHP,CA,AWP,WE,Federal Contract Tower,0,0,0,0,0,0,0,54,0,54,0,0,54,0,54,50,0,50,104
03/17/2022,WHP,CA,AWP,WE,Federal Contract Tower,0,0,0,0,0,0,0,116,0,116,0,0,116,0,116,182,0,182,298
03/18/2022,WHP,CA,AWP,WE,Federal Contract Tower,0,0,2,0,2,0,0,183,0,183,0,0,185,0,185,312,0,312,497
03/19/2022,WHP,CA,AWP,WE,Federal Contract Tower,0,0,1,0,1,0,0,134,0,134,0,0,135,0,135,221,0,221,356
03/20/2022,WHP,CA,AWP,WE,Federal Contract Tower,0,0,1,0,1,0,0,28,0,28,0,0,29,0,29,4,0,4,33
03/21/2022,WHP,CA,AWP,WE,Federal Contract Tower,0,0,0,0,0,0,0,38,0,38,0,0,38,0,38,2,0,2,40
03/22/2022,WHP,CA,AWP,WE,Federal Contract Tower,0,0,0,0,0,0,0,148,0,148,0,0,148,0,148,400,0,400,548
03/23/2022,WHP,CA,AWP,WE,Federal Contract Tower,0,0,0,0,0,0,0,163,0,163,0,0,163,0,163,354,0,354,517
03/24/2022,WHP,CA,AWP,WE,Federal Contract Tower,0,0,0,0,0,0,0,148,0,148,0,0,148,0,148,336,0,336,484
03/25/2022,WHP,CA,AWP,WE,Federal Contract Tower,0,0,0,0,0,0,0,170,0,170,0,0,170,0,170,344,0,344,514
03/26/2022,WHP,CA,AWP,WE,Federal Contract Tower,0,0,0,0,0,0,0,244,0,244,0,0,244,0,244,248,0,248,492
03/27/2022,WHP,CA,AWP,WE,Federal Contract Tower,0,0,1,0,1,0,0,75,0,75,0,0,76,0,76,261,0,261,337
03/28/2022,WHP,CA,AWP,WE,Federal Contract Tower,0,0,0,0,0,0,0,10,0,10,0,0,10,0,10,4,0,4,14
03/29/2022,WHP,CA,AWP,WE,Federal Contract Tower,0,0,2,0,2,0,0,129,0,129,0,0,131,0,131,308,0,308,439
03/30/2022,WHP,CA,AWP,WE,Federal Contract Tower,0,0,1,0,1,0,0,149,0,149,0,0,150,0,150,312,0,312,462
03/31/2022,WHP,CA,AWP,WE,Federal Contract Tower,0,0,2,0,2,0,0,114,0,114,0,0,116,0,116,274,0,274,390
04/01/2022,WHP,CA,AWP,WE,Federal Contract Tower,0,0,3,0,3,0,0,165,0,165,0,0,168,0,168,366,0,366,534
04/02/2022,WHP,CA,AWP,WE,Federal Contract Tower,0,0,6,0,6,0,0,50,0,50,0,0,56,0,56,168,0,168,224
04/03/2022,WHP,CA,AWP,WE,Federal Contract Tower,0,0,8,0,8,0,0,11,0,11,0,0,19,0,19,386,0,386,405
04/04/2022,WHP,CA,AWP,WE,Federal Contract Tower,0,0,0,0,0,0,0,74,0,74,0,0,74,0,74,24,0,24,98
04/05/2022,WHP,CA,AWP,WE,Federal Contract Tower,0,0,0,0,0,0,0,45,0,45,0,0,45,0,45,0,0,0,45
04/06/2022,WHP,CA,AWP,WE,Federal Contract Tower,0,0,0,0,0,0,0,135,0,135,0,0,135,0,135,224,0,224,359
04/07/2022,WHP,CA,AWP,WE,Federal Contract Tower,0,0,0,0,0,0,0,55,0,55,0,0,55,0,55,94,0,94,149
04/08/2022,WHP,CA,AWP,WE,Federal Contract Tower,0,0,0,0,0,0,0,107,0,107,0,0,107,0,107,234,0,234,341
04/09/2022,WHP,CA,AWP,WE,Federal Contract Tower,0,0,1,0,1,0,0,142,0,142,0,0,143,0,143,284,0,284,427
04/10/2022,WHP,CA,AWP,WE,Federal Contract Tower,0,0,3,0,3,0,0,121,0,121,0,0,124,0,124,284,0,284,408
04/11/2022,WHP,CA,AWP,WE,Federal Contract Tower,0,0,3,0,3,0,0,73,0,73,0,0,76,0,76,26,0,26,102
04/12/2022,WHP,CA,AWP,WE,Federal Contract Tower,0,0,0,0,0,0,0,42,0,42,0,0,42,0,42,16,0,16,58
04/13/2022,WHP,CA,AWP,WE,Federal Contract Tower,0,0,0,0,0,0,0,129,0,129,0,0,129,0,129,170,0,170,299
04/14/2022,WHP,CA,AWP,WE,Federal Contract Tower,0,0,0,0,0,0,0,250,0,250,0,0,250,0,250,440,0,440,690
04/15/2022,WHP,CA,AWP,WE,Federal Contract Tower,0,0,1,0,1,0,0,182,0,182,0,0,183,0,183,270,0,270,453
04/16/2022,WHP,CA,AWP,WE,Federal Contract Tower,0,0,0,0,0,0,0,118,0,118,0,0,118,0,118,278,0,278,396
04/17/2022,WHP,CA,AWP,WE,Federal Contract Tower,0,0,0,0,0,0,0,146,0,146,0,0,146,0,146,180,0,180,326
04/18/2022,WHP,CA,AWP,WE,Federal Contract Tower,0,0,1,0,1,0,0,100,0,100,0,0,101,0,101,212,0,212,313
04/19/2022,WHP,CA,AWP,WE,Federal Contract Tower,0,0,0,0,0,0,0,89,0,89,0,0,89,0,89,250,0,250,339
04/20/2022,WHP,CA,AWP,WE,Federal Contract Tower,0,0,5,0,5,0,0,85,0,85,0,0,90,0,90,146,0,146,236
04/21/2022,WHP,CA,AWP,WE,Federal Contract Tower,0,0,1,0,1,0,0,99,0,99,0,0,100,0,100,206,0,206,306
04/22/2022,WHP,CA,AWP,WE,Federal Contract Tower,0,0,2,0,2,0,0,107,0,107,0,0,109,0,109,246,0,246,355
04/23/2022,WHP,CA,AWP,WE,Federal Contract Tower,0,0,0,0,0,0,0,159,0,159,0,0,159,0,159,302,0,302,461
04/24/2022,WHP,CA,AWP,WE,Federal Contract Tower,0,0,0,0,0,0,0,50,0,50,0,0,50,0,50,34,0,34,84
04/25/2022,WHP,CA,AWP,WE,Federal Contract Tower,0,0,0,0,0,0,0,108,0,108,0,0,108,0,108,292,0,292,400
04/26/2022,WHP,CA,AWP,WE,Federal Contract Tower,0,0,0,0,0,0,0,130,0,130,0,0,130,0,130,312,0,312,442
04/27/2022,WHP,CA,AWP,WE,Federal Contract Tower,0,0,3,0,3,0,0,134,0,134,0,0,137,0,137,264,0,264,401
04/28/2022,WHP,CA,AWP,WE,Federal Contract Tower,0,0,6,0,6,0,0,73,0,73,0,0,79,0,79,216,0,216,295
04/29/2022,WHP,CA,AWP,WE,Federal Contract Tower,0,0,1,0,1,0,0,125,0,125,0,0,126,0,126,282,0,282,408
04/30/2022,WHP,CA,AWP,WE,Federal Contract Tower,0,0,1,0,1,0,0,130,0,130,0,0,131,0,131,252,0,252,383
05/01/2022,WHP,CA,AWP,WE,Federal Contract Tower,0,0,0,0,0,0,0,144,0,144,0,0,144,0,144,298,0,298,442
05/02/2022,WHP,CA,AWP,WE,Federal Contract Tower,0,0,1,0,1,0,0,101,0,101,0,0,102,0,102,274,0,274,376
05/03/2022,WHP,CA,AWP,WE,Federal Contract Tower,0,0,0,0,0,0,0,117,0,117,0,0,117,0,117,196,0,196,313
05/04/2022,WHP,CA,AWP,WE,Federal Contract Tower,0,0,2,0,2,0,0,166,0,166,0,0,168,0,168,448,0,448,616
05/05/2022,WHP,CA,AWP,WE,Federal Contract Tower,0,0,0,0,0,0,0,171,0,171,0,0,171,0,171,348,0,348,519
05/06/2022,WHP,CA,AWP,WE,Federal Contract Tower,0,0,0,0,0,0,0,125,0,125,0,0,125,0,125,186,0,186,311
05/07/2022,WHP,CA,AWP,WE,Federal Contract Tower,0,0,0,0,0,0,0,166,0,166,0,0,166,0,166,314,0,314,480
05/08/2022,WHP,CA,AWP,WE,Federal Contract Tower,0,0,2,0,2,0,0,94,0,94,0,0,96,0,96,214,0,214,310
05/09/2022,WHP,CA,AWP,WE,Federal Contract Tower,0,0,1,0,1,0,0,72,0,72,0,0,73,0,73,64,0,64,137
05/10/2022,WHP,CA,AWP,WE,Federal Contract Tower,0,0,0,0,0,0,0,74,0,74,0,0,74,0,74,36,0,36,110
05/11/2022,WHP,CA,AWP,WE,Federal Contract Tower,0,0,0,0,0,0,0,50,0,50,0,0,50,0,50,22,0,22,72
05/12/2022,WHP,CA,AWP,WE,Federal Contract Tower,0,0,3,0,3,0,0,141,0,141,0,0,144,0,144,244,0,244,388
05/13/2022,WHP,CA,AWP,WE,Federal Contract Tower,0,0,0,0,0,0,0,135,0,135,0,0,135,0,135,306,0,306,441
05/14/2022,WHP,CA,AWP,WE,Federal Contract Tower,0,0,0,0,0,0,0,155,0,155,0,0,155,0,155,216,0,216,371
05/15/2022,WHP,CA,AWP,WE,Federal Contract Tower,0,0,0,0,0,0,0,158,0,158,0,0,158,0,158,254,0,254,412
05/16/2022,WHP,CA,AWP,WE,Federal Contract Tower,0,0,2,0,2,0,0,113,0,113,0,0,115,0,115,240,0,240,355
05/17/2022,WHP,CA,AWP,WE,Federal Contract Tower,0,0,1,0,1,0,0,85,0,85,0,0,86,0,86,188,0,188,274
05/18/2022,WHP,CA,AWP,WE,Federal Contract Tower,0,0,0,0,0,0,0,128,0,128,0,0,128,0,128,300,0,300,428
05/19/2022,WHP,CA,AWP,WE,Federal Contract Tower,0,0,2,0,2,0,0,84,0,84,0,0,86,0,86,168,0,168,254
05/20/2022,WHP,CA,AWP,WE,Federal Contract Tower,0,0,0,0,0,0,0,61,0,61,0,0,61,0,61,160,0,160,221
05/21/2022,WHP,CA,AWP,WE,Federal Contract Tower,0,0,4,0,4,0,0,153,0,153,0,0,157,0,157,356,0,356,513
05/22/2022,WHP,CA,AWP,WE,Federal Contract Tower,0,0,0,0,0,0,0,139,0,139,0,0,139,0,139,326,0,326,465
05/23/2022,WHP,CA,AWP,WE,Federal Contract Tower,0,0,4,0,4,0,0,73,0,73,0,0,77,0,77,190,0,190,267
05/24/2022,WHP,CA,AWP,WE,Federal Contract Tower,0,0,2,0,2,0,0,150,0,150,0,0,152,0,152,304,0,304,456
05/25/2022,WHP,CA,AWP,WE,Federal Contract Tower,0,0,2,0,2,0,0,168,0,168,0,0,170,0,170,394,0,394,564
05/26/2022,WHP,CA,AWP,WE,Federal Contract Tower,0,0,1,0,1,0,0,125,0,125,0,0,126,0,126,324,0,324,450
05/27/2022,WHP,CA,AWP,WE,Federal Contract Tower,0,0,2,0,2,0,0,110,0,110,0,0,112,0,112,180,0,180,292
05/28/2022,WHP,CA,AWP,WE,Federal Contract Tower,0,0,5,0,5,0,0,187,0,187,0,0,192,0,192,208,0,208,400
05/29/2022,WHP,CA,AWP,WE,Federal Contract Tower,0,0,2,0,2,0,0,59,0,59,0,0,61,0,61,44,0,44,105
05/30/2022,WHP,CA,AWP,WE,Federal Contract Tower,0,0,0,0,0,0,0,125,0,125,0,0,125,0,125,154,0,154,279
05/31/2022,WHP,CA,AWP,WE,Federal Contract Tower,0,0,2,0,2,0,0,145,0,145,0,0,147,0,147,318,0,318,465
06/01/2022,WHP,CA,AWP,WE,Federal Contract Tower,0,0,0,0,0,0,0,111,0,111,0,0,111,0,111,326,0,326,437
06/02/2022,WHP,CA,AWP,WE,Federal Contract Tower,0,0,0,0,0,0,0,140,0,140,0,0,140,0,140,334,0,334,474
06/03/2022,WHP,CA,AWP,WE,Federal Contract Tower,0,0,3,0,3,0,0,93,0,93,0,0,96,0,96,194,0,194,290
06/04/2022,WHP,CA,AWP,WE,Federal Contract Tower,0,0,6,0,6,0,0,127,0,127,0,0,133,0,133,286,0,286,419
06/05/2022,WHP,CA,AWP,WE,Federal Contract Tower,0,0,4,0,4,0,0,109,0,109,0,0,113,0,113,236,0,236,349
06/06/2022,WHP,CA,AWP,WE,Federal Contract Tower,0,0,3,0,3,0,0,97,0,97,0,0,100,0,100,180,0,180,280
06/07/2022,WHP,CA,AWP,WE,Federal Contract Tower,0,0,0,0,0,0,0,89,0,89,0,0,89,0,89,334,0,334,423
06/08/2022,WHP,CA,AWP,WE,Federal Contract Tower,0,0,0,0,0,0,0,71,0,71,0,0,71,0,71,194,0,194,265
06/09/2022,WHP,CA,AWP,WE,Federal Contract Tower,0,0,1,0,1,0,0,21,0,21,0,0,22,0,22,0,0,0,22
06/10/2022,WHP,CA,AWP,WE,Federal Contract Tower,0,0,3,0,3,0,0,39,0,39,0,0,42,0,42,0,0,0,42
06/11/2022,WHP,CA,AWP,WE,Federal Contract Tower,0,0,2,0,2,0,0,102,0,102,0,0,104,0,104,64,0,64,168
06/12/2022,WHP,CA,AWP,WE,Federal Contract Tower,0,0,0,0,0,0,0,137,0,137,0,0,137,0,137,214,0,214,351
06/13/2022,WHP,CA,AWP,WE,Federal Contract Tower,0,0,1,0,1,0,0,95,0,95,0,0,96,0,96,204,0,204,300
06/14/2022,WHP,CA,AWP,WE,Federal Contract Tower,0,0,1,0,1,0,0,120,0,120,0,0,121,0,121,414,0,414,535
06/15/2022,WHP,CA,AWP,WE,Federal Contract Tower,0,0,2,0,2,0,0,97,0,97,0,0,99,0,99,316,0,316,415
06/16/2022,WHP,CA,AWP,WE,Federal Contract Tower,0,0,0,0,0,0,0,118,0,118,0,0,118,0,118,282,0,282,400
06/17/2022,WHP,CA,AWP,WE,Federal Contract Tower,0,0,1,0,1,0,0,116,0,116,0,0,117,0,117,142,0,142,259
06/18/2022,WHP,CA,AWP,WE,Federal Contract Tower,0,0,1,0,1,0,0,162,0,162,0,0,163,0,163,256,0,256,419
06/19/2022,WHP,CA,AWP,WE,Federal Contract Tower,0,0,0,0,0,0,0,98,0,98,0,0,98,0,98,102,0,102,200
06/20/2022,WHP,CA,AWP,WE,Federal Contract Tower,0,0,0,0,0,0,0,143,0,143,0,0,143,0,143,250,0,250,393
06/21/2022,WHP,CA,AWP,WE,Federal Contract Tower,0,0,1,0,1,0,0,126,0,126,0,0,127,0,127,396,0,396,523
06/22/2022,WHP,CA,AWP,WE,Federal Contract Tower,0,0,0,0,0,0,0,51,0,51,0,0,51,0,51,142,0,142,193
06/23/2022,WHP,CA,AWP,WE,Federal Contract Tower,0,1,0,0,1,0,0,115,0,115,0,1,115,0,116,316,0,316,432
06/24/2022,WHP,CA,AWP,WE,Federal Contract Tower,0,0,0,0,0,0,0,105,0,105,0,0,105,0,105,226,0,226,331
06/25/2022,WHP,CA,AWP,WE,Federal Contract Tower,0,0,2,0,2,0,0,238,0,238,0,0,240,0,240,0,0,0,240
06/26/2022,WHP,CA,AWP,WE,Federal Contract Tower,0,0,0,0,0,0,0,104,0,104,0,0,104,0,104,208,0,208,312
06/27/2022,WHP,CA,AWP,WE,Federal Contract Tower,0,0,1,0,1,0,0,95,0,95,0,0,96,0,96,146,0,146,242
06/28/2022,WHP,CA,AWP,WE,Federal Contract Tower,4,0,0,0,4,0,0,81,0,81,4,0,81,0,85,212,0,212,297
06/29/2022,WHP,CA,AWP,WE,Federal Contract Tower,0,0,0,0,0,0,0,137,0,137,0,0,137,0,137,252,0,252,389
06/30/2022,WHP,CA,AWP,WE,Federal Contract Tower,0,0,0,0,0,0,0,122,0,122,0,0,122,0,122,302,0,302,424
07/01/2022,WHP,CA,AWP,WE,Federal Contract Tower,0,0,0,0,0,0,0,113,0,113,0,0,113,0,113,276,0,276,389
07/02/2022,WHP,CA,AWP,WE,Federal Contract Tower,0,0,0,0,0,0,0,123,0,123,0,0,123,0,123,250,0,250,373
07/03/2022,WHP,CA,AWP,WE,Federal Contract Tower,0,0,1,0,1,0,0,120,0,120,0,0,121,0,121,170,0,170,291
07/04/2022,WHP,CA,AWP,WE,Federal Contract Tower,0,0,0,0,0,0,0,70,0,70,0,0,70,0,70,84,0,84,154
07/05/2022,WHP,CA,AWP,WE,Federal Contract Tower,0,0,1,0,1,0,0,68,0,68,0,0,69,0,69,96,0,96,165
07/06/2022,WHP,CA,AWP,WE,Federal Contract Tower,0,0,3,0,3,0,0,93,0,93,0,0,96,0,96,276,0,276,372
07/07/2022,WHP,CA,AWP,WE,Federal Contract Tower,0,0,3,0,3,0,0,125,0,125,0,0,128,0,128,318,0,318,446
07/08/2022,WHP,CA,AWP,WE,Federal Contract Tower,0,0,0,0,0,0,0,133,0,133,0,0,133,0,133,264,0,264,397
07/09/2022,WHP,CA,AWP,WE,Federal Contract Tower,0,0,0,0,0,0,0,112,0,112,0,0,112,0,112,182,0,182,294
07/10/2022,WHP,CA,AWP,WE,Federal Contract Tower,0,0,0,0,0,0,0,127,0,127,0,0,127,0,127,236,0,236,363
07/11/2022,WHP,CA,AWP,WE,Federal Contract Tower,0,0,0,0,0,0,0,92,0,92,0,0,92,0,92,213,0,213,305
07/12/2022,WHP,CA,AWP,WE,Federal Contract Tower,0,0,0,0,0,0,0,145,0,145,0,0,145,0,145,414,0,414,559
07/13/2022,WHP,CA,AWP,WE,Federal Contract Tower,0,0,1,0,1,0,0,135,0,135,0,0,136,0,136,296,0,296,432
07/14/2022,WHP,CA,AWP,WE,Federal Contract Tower,0,0,0,0,0,0,0,134,0,134,0,0,134,0,134,300,0,300,434
07/15/2022,WHP,CA,AWP,WE,Federal Contract Tower,0,0,0,0,0,0,0,110,0,110,0,0,110,0,110,214,0,214,324
07/16/2022,WHP,CA,AWP,WE,Federal Contract Tower,0,0,2,0,2,0,0,92,0,92,0,0,94,0,94,174,0,174,268
07/17/2022,WHP,CA,AWP,WE,Federal Contract Tower,0,0,1,0,1,0,0,99,0,99,0,0,100,0,100,142,0,142,242
07/18/2022,WHP,CA,AWP,WE,Federal Contract Tower,0,0,1,0,1,0,0,98,0,98,0,0,99,0,99,28,0,28,127
07/19/2022,WHP,CA,AWP,WE,Federal Contract Tower,0,0,1,0,1,0,0,124,0,124,0,0,125,0,125,268,0,268,393
07/20/2022,WHP,CA,AWP,WE,Federal Contract Tower,0,0,0,0,0,0,0,146,0,146,0,0,146,0,146,324,0,324,470
07/21/2022,WHP,CA,AWP,WE,Federal Contract Tower,0,0,0,0,0,0,0,111,0,111,0,0,111,0,111,202,0,202,313
07/22/2022,WHP,CA,AWP,WE,Federal Contract Tower,0,0,0,0,0,0,0,128,0,128,0,0,128,0,128,170,0,170,298
07/23/2022,WHP,CA,AWP,WE,Federal Contract Tower,0,0,0,0,0,0,0,156,0,156,0,0,156,0,156,98,0,98,254
07/24/2022,WHP,CA,AWP,WE,Federal Contract Tower,0,0,2,0,2,0,0,82,0,82,0,0,84,0,84,118,0,118,202
07/25/2022,WHP,CA,AWP,WE,Federal Contract Tower,0,0,0,0,0,0,0,114,0,114,0,0,114,0,114,246,0,246,360
07/26/2022,WHP,CA,AWP,WE,Federal Contract Tower,0,0,0,0,0,0,0,151,0,151,0,0,151,0,151,370,0,370,521
07/27/2022,WHP,CA,AWP,WE,Federal Contract Tower,0,1,0,0,1,0,0,116,0,116,0,1,116,0,117,248,0,248,365
07/28/2022,WHP,CA,AWP,WE,Federal Contract Tower,0,0,2,0,2,0,0,116,0,116,0,0,118,0,118,202,0,202,320
07/29/2022,WHP,CA,AWP,WE,Federal Contract Tower,0,0,0,0,0,0,0,123,0,123,0,0,123,0,123,231,0,231,354
07/30/2022,WHP,CA,AWP,WE,Federal Contract Tower,0,0,1,0,1,0,0,88,0,88,0,0,89,0,89,185,0,185,274
07/31/2022,WHP,CA,AWP,WE,Federal Contract Tower,0,0,0,0,0,0,0,112,0,112,0,0,112,0,112,260,0,260,372
08/01/2022,WHP,CA,AWP,WE,Federal Contract Tower,0,0,0,0,0,0,0,93,0,93,0,0,93,0,93,146,0,146,239
08/02/2022,WHP,CA,AWP,WE,Federal Contract Tower,0,0,0,0,0,0,0,142,0,142,0,0,142,0,142,230,0,230,372
08/03/2022,WHP,CA,AWP,WE,Federal Contract Tower,0,0,0,0,0,0,0,138,0,138,0,0,138,0,138,256,0,256,394
08/04/2022,WHP,CA,AWP,WE,Federal Contract Tower,0,0,0,0,0,0,0,147,0,147,0,0,147,0,147,318,0,318,465
08/05/2022,WHP,CA,AWP,WE,Federal Contract Tower,0,0,2,0,2,0,0,117,0,117,0,0,119,0,119,126,0,126,245
08/06/2022,WHP,CA,AWP,WE,Federal Contract Tower,0,0,0,0,0,0,0,94,0,94,0,0,94,0,94,142,0,142,236
08/07/2022,WHP,CA,AWP,WE,Federal Contract Tower,0,0,1,0,1,0,0,134,0,134,0,0,135,0,135,128,0,128,263
08/08/2022,WHP,CA,AWP,WE,Federal Contract Tower,0,0,0,0,0,0,0,62,0,62,0,0,62,0,62,110,0,110,172
08/09/2022,WHP,CA,AWP,WE,Federal Contract Tower,0,0,2,0,2,0,0,119,0,119,0,0,121,0,121,200,0,200,321
08/10/2022,WHP,CA,AWP,WE,Federal Contract Tower,0,0,2,0,2,0,0,118,0,118,0,0,120,0,120,174,0,174,294
08/11/2022,WHP,CA,AWP,WE,Federal Contract Tower,0,0,0,0,0,0,0,106,0,106,0,0,106,0,106,156,0,156,262
08/12/2022,WHP,CA,AWP,WE,Federal Contract Tower,0,0,0,0,0,0,0,114,0,114,0,0,114,0,114,172,0,172,286
08/13/2022,WHP,CA,AWP,WE,Federal Contract Tower,0,0,1,0,1,0,0,102,0,102,0,0,103,0,103,126,0,126,229
08/14/2022,WHP,CA,AWP,WE,Federal Contract Tower,0,0,1,0,1,0,0,131,0,131,0,0,132,0,132,78,0,78,210
08/15/2022,WHP,CA,AWP,WE,Federal Contract Tower,0,0,1,0,1,0,0,92,0,92,0,0,93,0,93,152,0,152,245
08/16/2022,WHP,CA,AWP,WE,Federal Contract Tower,0,0,0,0,0,0,0,103,0,103,0,0,103,0,103,174,0,174,277
08/17/2022,WHP,CA,AWP,WE,Federal Contract Tower,0,0,1,0,1,0,0,118,0,118,0,0,119,0,119,216,0,216,335
08/18/2022,WHP,CA,AWP,WE,Federal Contract Tower,0,0,1,0,1,0,0,137,0,137,0,0,138,0,138,226,0,226,364
08/19/2022,WHP,CA,AWP,WE,Federal Contract Tower,0,0,0,0,0,0,0,101,0,101,0,0,101,0,101,188,0,188,289
08/20/2022,WHP,CA,AWP,WE,Federal Contract Tower,0,0,2,0,2,0,0,111,0,111,0,0,113,0,113,104,0,104,217
08/21/2022,WHP,CA,AWP,WE,Federal Contract Tower,0,0,8,0,8,0,0,116,0,116,0,0,124,0,124,148,0,148,272
08/22/2022,WHP,CA,AWP,WE,Federal Contract Tower,0,0,2,0,2,0,0,81,0,81,0,0,83,0,83,170,0,170,253
08/23/2022,WHP,CA,AWP,WE,Federal Contract Tower,0,0,1,0,1,0,0,120,0,120,0,0,121,0,121,212,0,212,333
08/24/2022,WHP,CA,AWP,WE,Federal Contract Tower,0,0,0,0,0,0,0,104,0,104,0,0,104,0,104,198,0,198,302
08/25/2022,WHP,CA,AWP,WE,Federal Contract Tower,0,0,1,0,1,0,0,148,0,148,0,0,149,0,149,168,0,168,317
08/26/2022,WHP,CA,AWP,WE,Federal Contract Tower,0,0,0,0,0,0,0,124,0,124,0,0,124,0,124,192,0,192,316
08/27/2022,WHP,CA,AWP,WE,Federal Contract Tower,0,0,1,0,1,0,0,196,0,196,0,0,197,0,197,96,0,96,293
08/28/2022,WHP,CA,AWP,WE,Federal Contract Tower,0,0,3,0,3,0,0,100,0,100,0,0,103,0,103,162,0,162,265
08/29/2022,WHP,CA,AWP,WE,Federal Contract Tower,0,0,0,0,0,0,0,90,0,90,0,0,90,0,90,188,0,188,278
08/30/2022,WHP,CA,AWP,WE,Federal Contract Tower,0,0,0,0,0,0,0,82,0,82,0,0,82,0,82,106,0,106,188
08/31/2022,WHP,CA,AWP,WE,Federal Contract Tower,0,0,1,0,1,0,0,71,0,71,0,0,72,0,72,58,0,58,130
09/01/2022,WHP,CA,AWP,WE,Federal Contract Tower,0,0,1,0,1,0,0,91,0,91,0,0,92,0,92,80,0,80,172
09/02/2022,WHP,CA,AWP,WE,Federal Contract Tower,0,0,0,0,0,0,0,86,0,86,0,0,86,0,86,144,0,144,230
09/03/2022,WHP,CA,AWP,WE,Federal Contract Tower,0,0,1,0,1,0,0,73,0,73,0,0,74,0,74,96,0,96,170
09/04/2022,WHP,CA,AWP,WE,Federal Contract Tower,0,0,4,0,4,0,0,62,0,62,0,0,66,0,66,80,0,80,146
09/05/2022,WHP,CA,AWP,WE,Federal Contract Tower,0,0,0,0,0,0,0,61,0,61,0,0,61,0,61,72,0,72,133
09/06/2022,WHP,CA,AWP,WE,Federal Contract Tower,0,0,0,0,0,0,0,112,0,112,0,0,112,0,112,160,0,160,272
09/07/2022,WHP,CA,AWP,WE,Federal Contract Tower,0,0,0,0,0,0,0,103,0,103,0,0,103,0,103,120,0,120,223
09/08/2022,WHP,CA,AWP,WE,Federal Contract Tower,0,0,0,0,0,0,0,87,0,87,0,0,87,0,87,84,0,84,171
09/09/2022,WHP,CA,AWP,WE,Federal Contract Tower,0,0,0,0,0,0,0,73,0,73,0,0,73,0,73,112,0,112,185
09/10/2022,WHP,CA,AWP,WE,Federal Contract Tower,0,0,1,0,1,0,0,37,0,37,0,0,38,0,38,120,0,120,158
09/11/2022,WHP,CA,AWP,WE,Federal Contract Tower,0,0,2,0,2,0,0,67,0,67,0,0,69,0,69,156,0,156,225
09/12/2022,WHP,CA,AWP,WE,Federal Contract Tower,0,0,0,0,0,0,0,86,0,86,0,0,86,0,86,224,0,224,310
09/13/2022,WHP,CA,AWP,WE,Federal Contract Tower,0,0,0,0,0,0,0,129,0,129,0,0,129,0,129,150,0,150,279
09/14/2022,WHP,CA,AWP,WE,Federal Contract Tower,0,0,2,0,2,0,0,97,0,97,0,0,99,0,99,144,0,144,243
09/15/2022,WHP,CA,AWP,WE,Federal Contract Tower,0,0,0,0,0,0,0,128,0,128,0,0,128,0,128,258,0,258,386
09/16/2022,WHP,CA,AWP,WE,Federal Contract Tower,0,0,0,0,0,0,0,100,0,100,0,0,100,0,100,203,0,203,303
09/17/2022,WHP,CA,AWP,WE,Federal Contract Tower,0,0,2,0,2,0,0,48,0,48,0,0,50,0,50,234,0,234,284
09/18/2022,WHP,CA,AWP,WE,Federal Contract Tower,0,0,0,0,0,0,0,103,0,103,0,0,103,0,103,190,0,190,293
09/19/2022,WHP,CA,AWP,WE,Federal Contract Tower,0,0,0,0,0,0,0,100,0,100,0,0,100,0,100,194,0,194,294
09/20/2022,WHP,CA,AWP,WE,Federal Contract Tower,0,0,0,0,0,0,0,113,0,113,0,0,113,0,113,210,0,210,323
09/21/2022,WHP,CA,AWP,WE,Federal Contract Tower,0,0,0,0,0,0,0,76,0,76,0,0,76,0,76,116,0,116,192
09/22/2022,WHP,CA,AWP,WE,Federal Contract Tower,0,0,1,0,1,0,0,112,0,112,0,0,113,0,113,136,0,136,249
09/23/2022,WHP,CA,AWP,WE,Federal Contract Tower,0,0,0,0,0,0,0,108,0,108,0,0,108,0,108,92,0,92,200
09/24/2022,WHP,CA,AWP,WE,Federal Contract Tower,0,0,0,0,0,0,0,172,0,172,0,0,172,0,172,38,0,38,210
09/25/2022,WHP,CA,AWP,WE,Federal Contract Tower,0,0,0,0,0,0,0,129,0,129,0,0,129,0,129,98,0,98,227
09/26/2022,WHP,CA,AWP,WE,Federal Contract Tower,0,0,0,0,0,0,0,91,0,91,0,0,91,0,91,52,0,52,143
09/27/2022,WHP,CA,AWP,WE,Federal Contract Tower,0,0,0,0,0,0,0,120,0,120,0,0,120,0,120,154,0,154,274
09/28/2022,WHP,CA,AWP,WE,Federal Contract Tower,0,0,1,0,1,0,0,91,0,91,0,0,92,0,92,188,0,188,280
09/29/2022,WHP,CA,AWP,WE,Federal Contract Tower,0,0,0,0,0,0,0,131,0,131,0,0,131,0,131,198,0,198,329
09/30/2022,WHP,CA,AWP,WE,Federal Contract Tower,0,0,3,0,3,0,0,99,0,99,0,0,102,0,102,50,0,50,152
10/01/2022,WHP,CA,AWP,WE,Federal Contract Tower,0,0,3,0,3,0,0,103,0,103,0,0,106,0,106,160,0,160,266
10/02/2022,WHP,CA,AWP,WE,Federal Contract Tower,0,0,2,0,2,0,0,140,0,140,0,0,142,0,142,204,0,204,346
10/03/2022,WHP,CA,AWP,WE,Federal Contract Tower,0,0,0,0,0,0,0,78,0,78,0,0,78,0,78,114,0,114,192
10/04/2022,WHP,CA,AWP,WE,Federal Contract Tower,0,0,0,0,0,0,0,122,0,122,0,0,122,0,122,142,0,142,264
10/05/2022,WHP,CA,AWP,WE,Federal Contract Tower,0,0,0,0,0,0,0,100,0,100,0,0,100,0,100,222,0,222,322
10/06/2022,WHP,CA,AWP,WE,Federal Contract Tower,0,0,2,0,2,0,0,84,0,84,0,0,86,0,86,166,0,166,252
10/07/2022,WHP,CA,AWP,WE,Federal Contract Tower,0,0,4,0,4,0,0,77,0,77,0,0,81,0,81,54,0,54,135
10/08/2022,WHP,CA,AWP,WE,Federal Contract Tower,0,0,1,0,1,0,0,112,0,112,0,0,113,0,113,128,0,128,241
10/09/2022,WHP,CA,AWP,WE,Federal Contract Tower,0,0,0,0,0,0,0,139,0,139,0,0,139,0,139,208,0,208,347
10/10/2022,WHP,CA,AWP,WE,Federal Contract Tower,0,0,1,0,1,0,0,68,0,68,0,0,69,0,69,150,0,150,219
10/11/2022,WHP,CA,AWP,WE,Federal Contract Tower,0,0,1,0,1,0,0,95,0,95,0,0,96,0,96,180,0,180,276
10/12/2022,WHP,CA,AWP,WE,Federal Contract Tower,0,0,1,0,1,0,0,61,0,61,0,0,62,0,62,110,0,110,172
10/13/2022,WHP,CA,AWP,WE,Federal Contract Tower,0,0,2,0,2,0,0,33,0,33,0,0,35,0,35,2,0,2,37
10/14/2022,WHP,CA,AWP,WE,Federal Contract Tower,0,0,0,0,0,0,0,36,0,36,0,0,36,0,36,38,0,38,74
10/15/2022,WHP,CA,AWP,WE,Federal Contract Tower,0,0,4,0,4,0,0,12,0,12,0,0,16,0,16,10,0,10,26
10/16/2022,WHP,CA,AWP,WE,Federal Contract Tower,0,0,17,0,17,0,0,92,0,92,0,0,109,0,109,262,0,262,371
10/17/2022,WHP,CA,AWP,WE,Federal Contract Tower,0,0,0,0,0,0,0,121,0,121,0,0,121,0,121,160,0,160,281
10/18/2022,WHP,CA,AWP,WE,Federal Contract Tower,0,0,0,0,0,0,0,121,0,121,0,0,121,0,121,132,0,132,253
10/19/2022,WHP,CA,AWP,WE,Federal Contract Tower,0,0,1,0,1,0,0,91,0,91,0,0,92,0,92,158,0,158,250
10/20/2022,WHP,CA,AWP,WE,Federal Contract Tower,0,0,0,0,0,0,0,121,0,121,0,0,121,0,121,207,0,207,328
10/21/2022,WHP,CA,AWP,WE,Federal Contract Tower,0,0,0,0,0,0,0,139,0,139,0,0,139,0,139,140,0,140,279
10/22/2022,WHP,CA,AWP,WE,Federal Contract Tower,0,0,11,0,11,0,0,118,0,118,0,0,129,0,129,132,0,132,261
10/23/2022,WHP,CA,AWP,WE,Federal Contract Tower,0,0,0,0,0,0,0,80,0,80,0,0,80,0,80,88,0,88,168
10/24/2022,WHP,CA,AWP,WE,Federal Contract Tower,0,0,0,0,0,0,0,86,0,86,0,0,86,0,86,148,0,148,234
10/25/2022,WHP,CA,AWP,WE,Federal Contract Tower,0,0,0,0,0,0,0,132,0,132,0,0,132,0,132,252,0,252,384
10/26/2022,WHP,CA,AWP,WE,Federal Contract Tower,0,0,0,0,0,0,0,104,0,104,0,0,104,0,104,156,0,156,260
10/27/2022,WHP,CA,AWP,WE,Federal Contract Tower,0,0,1,0,1,0,0,83,0,83,0,0,84,0,84,202,0,202,286
10/28/2022,WHP,CA,AWP,WE,Federal Contract Tower,0,0,0,0,0,0,0,196,0,196,0,0,196,0,196,188,0,188,384
10/29/2022,WHP,CA,AWP,WE,Federal Contract Tower,0,0,1,0,1,0,0,115,0,115,0,0,116,0,116,90,0,90,206
10/30/2022,WHP,CA,AWP,WE,Federal Contract Tower,0,0,0,0,0,0,0,142,0,142,0,0,142,0,142,242,0,242,384
10/31/2022,WHP,CA,AWP,WE,Federal Contract Tower,0,0,2,0,2,0,0,76,0,76,0,0,78,0,78,144,0,144,222
11/01/2022,WHP,CA,AWP,WE,Federal Contract Tower,0,0,0,0,0,0,0,75,0,75,0,0,75,0,75,174,0,174,249
11/02/2022,WHP,CA,AWP,WE,Federal Contract Tower,0,0,0,0,0,0,0,50,0,50,0,0,50,0,50,74,0,74,124
11/03/2022,WHP,CA,AWP,WE,Federal Contract Tower,0,0,0,0,0,0,0,60,0,60,0,0,60,0,60,16,0,16,76
11/04/2022,WHP,CA,AWP,WE,Federal Contract Tower,0,0,2,0,2,0,0,130,0,130,0,0,132,0,132,218,0,218,350
11/05/2022,WHP,CA,AWP,WE,Federal Contract Tower,0,0,1,0,1,0,0,143,0,143,0,0,144,0,144,234,0,234,378
11/06/2022,WHP,CA,AWP,WE,Federal Contract Tower,0,0,1,0,1,0,0,149,0,149,0,0,150,0,150,280,0,280,430
11/07/2022,WHP,CA,AWP,WE,Federal Contract Tower,0,0,0,0,0,0,0,4,0,4,0,0,4,0,4,0,0,0,4
11/08/2022,WHP,CA,AWP,WE,Federal Contract Tower,0,0,0,0,0,0,0,34,0,34,0,0,34,0,34,0,0,0,34
11/09/2022,WHP,CA,AWP,WE,Federal Contract Tower,0,0,6,0,6,0,0,109,0,109,0,0,115,0,115,159,0,159,274
11/10/2022,WHP,CA,AWP,WE,Federal Contract Tower,0,0,1,0,1,0,0,141,0,141,0,0,142,0,142,328,0,328,470
11/11/2022,WHP,CA,AWP,WE,Federal Contract Tower,0,0,0,0,0,0,0,174,0,174,0,0,174,0,174,296,0,296,470
11/12/2022,WHP,CA,AWP,WE,Federal Contract Tower,0,0,0,0,0,0,0,164,0,164,0,0,164,0,164,4,0,4,168
11/13/2022,WHP,CA,AWP,WE,Federal Contract Tower,0,0,2,0,2,0,0,41,0,41,0,0,43,0,43,8,0,8,51
11/14/2022,WHP,CA,AWP,WE,Federal Contract Tower,0,0,0,0,0,0,0,127,0,127,0,0,127,0,127,218,0,218,345
11/15/2022,WHP,CA,AWP,WE,Federal Contract Tower,0,0,0,0,0,0,0,82,0,82,0,0,82,0,82,148,0,148,230
11/16/2022,WHP,CA,AWP,WE,Federal Contract Tower,0,0,0,0,0,0,0,22,0,22,0,0,22,0,22,0,0,0,22
11/17/2022,WHP,CA,AWP,WE,Federal Contract Tower,0,0,0,0,0,0,0,172,0,172,0,0,172,0,172,300,0,300,472
11/18/2022,WHP,CA,AWP,WE,Federal Contract Tower,0,0,1,0,1,0,0,138,0,138,0,0,139,0,139,194,0,194,333
11/19/2022,WHP,CA,AWP,WE,Federal Contract Tower,0,0,0,0,0,0,0,30,0,30,0,0,30,0,30,8,0,8,38
11/20/2022,WHP,CA,AWP,WE,Federal Contract Tower,0,0,0,0,0,0,0,153,0,153,0,0,153,0,153,128,0,128,281
11/21/2022,WHP,CA,AWP,WE,Federal Contract Tower,0,0,0,0,0,0,0,113,0,113,0,0,113,0,113,184,0,184,297
11/22/2022,WHP,CA,AWP,WE,Federal Contract Tower,0,0,4,0,4,0,0,157,0,157,0,0,161,0,161,400,0,400,561
11/23/2022,WHP,CA,AWP,WE,Federal Contract Tower,0,0,2,0,2,0,0,115,0,115,0,0,117,0,117,158,0,158,275
11/24/2022,WHP,CA,AWP,WE,Federal Contract Tower,0,0,0,0,0,0,0,17,0,17,0,0,17,0,17,0,0,0,17
11/25/2022,WHP,CA,AWP,WE,Federal Contract Tower,0,0,0,0,0,0,0,105,0,105,0,0,105,0,105,132,0,132,237
11/26/2022,WHP,CA,AWP,WE,Federal Contract Tower,0,0,0,0,0,0,0,189,0,189,0,0,189,0,189,92,0,92,281
11/27/2022,WHP,CA,AWP,WE,Federal Contract Tower,0,0,0,0,0,0,0,144,0,144,0,0,144,0,144,280,0,280,424
11/28/2022,WHP,CA,AWP,WE,Federal Contract Tower,0,0,6,0,6,0,0,43,0,43,0,0,49,0,49,64,0,64,113
11/29/2022,WHP,CA,AWP,WE,Federal Contract Tower,0,0,0,0,0,0,0,124,0,124,0,0,124,0,124,292,0,292,416
11/30/2022,WHP,CA,AWP,WE,Federal Contract Tower,0,0,5,0,5,0,0,80,0,80,0,0,85,0,85,114,0,114,199
12/01/2022,WHP,CA,AWP,WE,Federal Contract Tower,0,0,0,0,0,0,0,58,0,58,0,0,58,0,58,96,0,96,154
12/02/2022,WHP,CA,AWP,WE,Federal Contract Tower,0,0,4,0,4,0,0,12,0,12,0,0,16,0,16,10,0,10,26
12/03/2022,WHP,CA,AWP,WE,Federal Contract Tower,0,0,3,0,3,0,0,113,0,113,0,0,116,0,116,198,0,198,314
12/04/2022,WHP,CA,AWP,WE,Federal Contract Tower,0,0,5,0,5,0,0,6,0,6,0,0,11,0,11,8,0,8,19
12/05/2022,WHP,CA,AWP,WE,Federal Contract Tower,0,0,0,0,0,0,0,68,0,68,0,0,68,0,68,220,0,220,288
12/06/2022,WHP,CA,AWP,WE,Federal Contract Tower,0,0,1,0,1,0,0,120,0,120,0,0,121,0,121,304,0,304,425
12/07/2022,WHP,CA,AWP,WE,Federal Contract Tower,0,0,1,0,1,0,0,136,0,136,0,0,137,0,137,317,0,317,454
12/08/2022,WHP,CA,AWP,WE,Federal Contract Tower,0,0,0,0,0,0,0,126,0,126,0,0,126,0,126,242,0,242,368
12/09/2022,WHP,CA,AWP,WE,Federal Contract Tower,0,0,0,0,0,0,0,120,0,120,0,0,120,0,120,214,0,214,334
12/10/2022,WHP,CA,AWP,WE,Federal Contract Tower,0,0,0,0,0,0,0,27,0,27,0,0,27,0,27,80,0,80,107
12/11/2022,WHP,CA,AWP,WE,Federal Contract Tower,0,0,1,0,1,0,0,5,0,5,0,0,6,0,6,6,0,6,12
12/12/2022,WHP,CA,AWP,WE,Federal Contract Tower,0,0,1,0,1,0,0,43,0,43,0,0,44,0,44,222,0,222,266
12/13/2022,WHP,CA,AWP,WE,Federal Contract Tower,0,0,0,0,0,0,0,141,0,141,0,0,141,0,141,410,0,410,551
12/14/2022,WHP,CA,AWP,WE,Federal Contract Tower,0,0,2,0,2,0,0,118,0,118,0,0,120,0,120,298,0,298,418
12/15/2022,WHP,CA,AWP,WE,Federal Contract Tower,0,0,0,0,0,0,0,127,0,127,0,0,127,0,127,210,0,210,337
12/16/2022,WHP,CA,AWP,WE,Federal Contract Tower,0,0,0,0,0,0,0,108,0,108,0,0,108,0,108,254,0,254,362
12/17/2022,WHP,CA,AWP,WE,Federal Contract Tower,0,0,3,0,3,0,0,136,0,136,0,0,139,0,139,94,0,94,233
12/18/2022,WHP,CA,AWP,WE,Federal Contract Tower,0,0,0,0,0,0,0,161,0,161,0,0,161,0,161,256,0,256,417
12/19/2022,WHP,CA,AWP,WE,Federal Contract Tower,0,0,0,0,0,0,0,122,0,122,0,0,122,0,122,176,0,176,298
12/20/2022,WHP,CA,AWP,WE,Federal Contract Tower,0,0,3,0,3,0,0,141,0,141,0,0,144,0,144,332,0,332,476
12/21/2022,WHP,CA,AWP,WE,Federal Contract Tower,0,0,0,0,0,0,0,100,0,100,0,0,100,0,100,228,0,228,328
12/22/2022,WHP,CA,AWP,WE,Federal Contract Tower,0,0,3,0,3,0,0,108,0,108,0,0,111,0,111,230,0,230,341
12/23/2022,WHP,CA,AWP,WE,Federal Contract Tower,0,0,2,0,2,0,0,111,0,111,0,0,113,0,113,141,0,141,254
12/24/2022,WHP,CA,AWP,WE,Federal Contract Tower,0,0,0,0,0,0,0,71,0,71,0,0,71,0,71,37,0,37,108
12/25/2022,WHP,CA,AWP,WE,Federal Contract Tower,0,0,1,0,1,0,0,48,0,48,0,0,49,0,49,0,0,0,49
12/26/2022,WHP,CA,AWP,WE,Federal Contract Tower,0,0,1,0,1,0,0,94,0,94,0,0,95,0,95,160,0,160,255
12/27/2022,WHP,CA,AWP,WE,Federal Contract Tower,0,0,1,0,1,0,0,72,0,72,0,0,73,0,73,104,0,104,177
12/28/2022,WHP,CA,AWP,WE,Federal Contract Tower,0,0,4,0,4,0,0,81,0,81,0,0,85,0,85,114,0,114,199
12/29/2022,WHP,CA,AWP,WE,Federal Contract Tower,0,0,3,0,3,0,0,24,0,24,0,0,27,0,27,16,0,16,43
12/30/2022,WHP,CA,AWP,WE,Federal Contract Tower,0,0,10,0,10,0,0,8,0,8,0,0,18,0,18,12,0,12,30
12/31/2022,WHP,CA,AWP,WE,Federal Contract Tower,0,0,0,0,0,0,0,0,0,0,0,0,0,0,0,0,0,0,0
01/01/2023,WHP,CA,AWP,WE,Federal Contract Tower,0,0,1,0,1,0,0,38,0,38,0,0,39,0,39,60,0,60,99
01/02/2023,WHP,CA,AWP,WE,Federal Contract Tower,0,0,0,0,0,0,0,74,0,74,0,0,74,0,74,154,0,154,228
01/03/2023,WHP,CA,AWP,WE,Federal Contract Tower,0,0,0,0,0,0,0,9,0,9,0,0,9,0,9,2,0,2,11
01/04/2023,WHP,CA,AWP,WE,Federal Contract Tower,0,0,3,0,3,0,0,4,0,4,0,0,7,0,7,10,0,10,17
01/05/2023,WHP,CA,AWP,WE,Federal Contract Tower,0,0,0,0,0,0,0,18,0,18,0,0,18,0,18,0,0,0,18
01/06/2023,WHP,CA,AWP,WE,Federal Contract Tower,0,0,1,0,1,0,0,135,0,135,0,0,136,0,136,242,0,242,378
01/07/2023,WHP,CA,AWP,WE,Federal Contract Tower,0,0,4,0,4,0,0,96,0,96,0,0,100,0,100,156,0,156,256
01/08/2023,WHP,CA,AWP,WE,Federal Contract Tower,0,0,1,0,1,0,0,73,0,73,0,0,74,0,74,134,0,134,208
01/09/2023,WHP,CA,AWP,WE,Federal Contract Tower,0,0,0,0,0,0,0,0,0,0,0,0,0,0,0,0,0,0,0
01/10/2023,WHP,CA,AWP,WE,Federal Contract Tower,0,0,0,0,0,0,0,26,0,26,0,0,26,0,26,0,0,0,26
01/11/2023,WHP,CA,AWP,WE,Federal Contract Tower,0,0,1,0,1,0,0,118,0,118,0,0,119,0,119,198,0,198,317
01/12/2023,WHP,CA,AWP,WE,Federal Contract Tower,0,0,0,0,0,0,0,123,0,123,0,0,123,0,123,250,0,250,373
01/13/2023,WHP,CA,AWP,WE,Federal Contract Tower,0,0,2,0,2,0,0,100,0,100,0,0,102,0,102,254,0,254,356
01/14/2023,WHP,CA,AWP,WE,Federal Contract Tower,0,0,3,0,3,0,0,0,0,0,0,0,3,0,3,6,0,6,9
01/15/2023,WHP,CA,AWP,WE,Federal Contract Tower,0,0,2,0,2,0,0,23,0,23,0,0,25,0,25,86,0,86,111
01/16/2023,WHP,CA,AWP,WE,Federal Contract Tower,0,0,3,0,3,0,0,26,0,26,0,0,29,0,29,10,0,10,39
01/17/2023,WHP,CA,AWP,WE,Federal Contract Tower,0,0,1,0,1,0,0,66,0,66,0,0,67,0,67,223,0,223,290
01/18/2023,WHP,CA,AWP,WE,Federal Contract Tower,0,0,3,0,3,0,0,129,0,129,0,0,132,0,132,248,0,248,380
01/19/2023,WHP,CA,AWP,WE,Federal Contract Tower,0,0,1,0,1,0,0,66,0,66,0,0,67,0,67,198,0,198,265
01/20/2023,WHP,CA,AWP,WE,Federal Contract Tower,0,0,4,0,4,0,0,107,0,107,0,0,111,0,111,129,0,129,240
01/21/2023,WHP,CA,AWP,WE,Federal Contract Tower,0,0,2,0,2,0,0,154,0,154,0,0,156,0,156,172,0,172,328
01/22/2023,WHP,CA,AWP,WE,Federal Contract Tower,0,0,0,0,0,0,0,89,0,89,0,0,89,0,89,134,0,134,223
01/23/2023,WHP,CA,AWP,WE,Federal Contract Tower,0,0,1,0,1,0,0,20,0,20,0,0,21,0,21,0,0,0,21
01/24/2023,WHP,CA,AWP,WE,Federal Contract Tower,0,0,2,0,2,0,0,71,0,71,0,0,73,0,73,168,0,168,241
01/25/2023,WHP,CA,AWP,WE,Federal Contract Tower,0,0,3,0,3,0,0,86,2,88,0,0,89,2,91,114,0,114,205
01/26/2023,WHP,CA,AWP,WE,Federal Contract Tower,0,0,0,0,0,0,0,28,0,28,0,0,28,0,28,0,0,0,28
01/27/2023,WHP,CA,AWP,WE,Federal Contract Tower,0,0,2,0,2,0,0,117,0,117,0,0,119,0,119,258,0,258,377
01/28/2023,WHP,CA,AWP,WE,Federal Contract Tower,0,0,3,0,3,0,0,274,0,274,0,0,277,0,277,94,0,94,371
01/29/2023,WHP,CA,AWP,WE,Federal Contract Tower,0,0,0,0,0,0,0,23,0,23,0,0,23,0,23,94,0,94,117
01/30/2023,WHP,CA,AWP,WE,Federal Contract Tower,0,0,0,0,0,0,0,42,0,42,0,0,42,0,42,68,0,68,110
01/31/2023,WHP,CA,AWP,WE,Federal Contract Tower,0,0,0,0,0,0,0,50,0,50,0,0,50,0,50,16,0,16,66
02/01/2023,WHP,CA,AWP,WE,Federal Contract Tower,0,0,1,0,1,0,0,85,0,85,0,0,86,0,86,88,0,88,174
02/02/2023,WHP,CA,AWP,WE,Federal Contract Tower,0,0,2,0,2,0,0,130,0,130,0,0,132,0,132,210,0,210,342
02/03/2023,WHP,CA,AWP,WE,Federal Contract Tower,0,0,4,0,4,0,0,105,0,105,0,0,109,0,109,220,0,220,329
02/04/2023,WHP,CA,AWP,WE,Federal Contract Tower,0,0,0,0,0,0,0,126,0,126,0,0,126,0,126,100,0,100,226
02/05/2023,WHP,CA,AWP,WE,Federal Contract Tower,0,0,0,0,0,0,0,42,0,42,0,0,42,0,42,122,0,122,164
02/06/2023,WHP,CA,AWP,WE,Federal Contract Tower,0,0,0,0,0,0,0,48,0,48,0,0,48,0,48,20,0,20,68
02/07/2023,WHP,CA,AWP,WE,Federal Contract Tower,0,0,1,0,1,0,0,91,0,91,0,0,92,0,92,216,0,216,308
02/08/2023,WHP,CA,AWP,WE,Federal Contract Tower,0,0,1,0,1,0,0,132,0,132,0,0,133,0,133,248,0,248,381
02/09/2023,WHP,CA,AWP,WE,Federal Contract Tower,0,0,0,0,0,0,0,85,0,85,0,0,85,0,85,132,0,132,217
02/10/2023,WHP,CA,AWP,WE,Federal Contract Tower,0,0,1,0,1,0,0,124,0,124,0,0,125,0,125,214,0,214,339
02/11/2023,WHP,CA,AWP,WE,Federal Contract Tower,0,0,1,0,1,0,0,81,0,81,0,0,82,0,82,104,0,104,186
02/12/2023,WHP,CA,AWP,WE,Federal Contract Tower,0,0,0,0,0,0,0,95,0,95,0,0,95,0,95,186,0,186,281
02/13/2023,WHP,CA,AWP,WE,Federal Contract Tower,0,0,1,0,1,0,0,81,0,81,0,0,82,0,82,146,0,146,228
02/14/2023,WHP,CA,AWP,WE,Federal Contract Tower,0,0,0,0,0,0,0,50,0,50,0,0,50,0,50,138,0,138,188
02/15/2023,WHP,CA,AWP,WE,Federal Contract Tower,0,0,1,0,1,0,0,44,0,44,0,0,45,0,45,60,0,60,105
02/16/2023,WHP,CA,AWP,WE,Federal Contract Tower,0,0,0,0,0,0,0,116,0,116,0,0,116,0,116,248,0,248,364
02/17/2023,WHP,CA,AWP,WE,Federal Contract Tower,0,0,1,0,1,0,0,80,0,80,0,0,81,0,81,20,0,20,101
02/18/2023,WHP,CA,AWP,WE,Federal Contract Tower,0,0,1,0,1,0,0,109,0,109,0,0,110,0,110,170,0,170,280
02/19/2023,WHP,CA,AWP,WE,Federal Contract Tower,0,0,0,0,0,0,0,116,0,116,0,0,116,0,116,190,0,190,306
02/20/2023,WHP,CA,AWP,WE,Federal Contract Tower,0,0,1,0,1,0,0,103,0,103,0,0,104,0,104,124,0,124,228
02/22/2023,WHP,CA,AWP,WE,Federal Contract Tower,0,0,0,0,0,0,0,32,0,32,0,0,32,0,32,4,0,4,36
02/23/2023,WHP,CA,AWP,WE,Federal Contract Tower,0,0,2,0,2,0,0,14,0,14,0,0,16,0,16,24,0,24,40
02/24/2023,WHP,CA,AWP,WE,Federal Contract Tower,0,0,3,0,3,0,0,2,0,2,0,0,5,0,5,0,0,0,5
02/25/2023,WHP,CA,AWP,WE,Federal Contract Tower,0,0,0,0,0,0,0,10,0,10,0,0,10,0,10,0,0,0,10
02/26/2023,WHP,CA,AWP,WE,Federal Contract Tower,0,0,0,0,0,0,0,121,0,121,0,0,121,0,121,158,0,158,279
02/27/2023,WHP,CA,AWP,WE,Federal Contract Tower,0,0,0,0,0,0,0,2,0,2,0,0,2,0,2,0,0,0,2
02/28/2023,WHP,CA,AWP,WE,Federal Contract Tower,0,0,0,0,0,0,0,37,0,37,0,0,37,0,37,26,0,26,63
03/01/2023,WHP,CA,AWP,WE,Federal Contract Tower,0,0,0,0,0,0,0,28,0,28,0,0,28,0,28,18,0,18,46
03/02/2023,WHP,CA,AWP,WE,Federal Contract Tower,0,0,1,0,1,0,0,157,0,157,0,0,158,0,158,280,0,280,438
03/03/2023,WHP,CA,AWP,WE,Federal Contract Tower,0,0,0,0,0,0,0,134,0,134,0,0,134,0,134,13,0,13,147
03/04/2023,WHP,CA,AWP,WE,Federal Contract Tower,0,0,4,0,4,0,0,68,0,68,0,0,72,0,72,14,0,14,86
03/05/2023,WHP,CA,AWP,WE,Federal Contract Tower,0,0,0,0,0,0,0,58,0,58,0,0,58,0,58,130,0,130,188
03/06/2023,WHP,CA,AWP,WE,Federal Contract Tower,0,0,3,0,3,0,0,83,0,83,0,0,86,0,86,254,0,254,340
03/07/2023,WHP,CA,AWP,WE,Federal Contract Tower,0,0,0,0,0,0,0,144,0,144,0,0,144,0,144,350,0,350,494
03/08/2023,WHP,CA,AWP,WE,Federal Contract Tower,0,0,0,0,0,0,0,154,0,154,0,0,154,0,154,368,0,368,522
03/09/2023,WHP,CA,AWP,WE,Federal Contract Tower,0,0,0,0,0,0,0,171,0,171,0,0,171,0,171,354,0,354,525
03/10/2023,WHP,CA,AWP,WE,Federal Contract Tower,0,0,1,0,1,0,0,0,0,0,0,0,1,0,1,0,0,0,1
03/11/2023,WHP,CA,AWP,WE,Federal Contract Tower,0,0,4,0,4,0,0,2,0,2,0,0,6,0,6,0,0,0,6
03/12/2023,WHP,CA,AWP,WE,Federal Contract Tower,0,0,4,0,4,0,0,120,0,120,0,0,124,0,124,224,0,224,348
03/13/2023,WHP,CA,AWP,WE,Federal Contract Tower,0,0,5,0,5,0,0,62,0,62,0,0,67,0,67,134,0,134,201
03/14/2023,WHP,CA,AWP,WE,Federal Contract Tower,0,0,3,0,3,0,0,0,0,0,0,0,3,0,3,6,0,6,9
03/15/2023,WHP,CA,AWP,WE,Federal Contract Tower,0,0,2,0,2,0,0,27,0,27,0,0,29,0,29,16,0,16,45
03/16/2023,WHP,CA,AWP,WE,Federal Contract Tower,0,0,3,0,3,0,0,96,0,96,0,0,99,0,99,256,0,256,355
03/17/2023,WHP,CA,AWP,WE,Federal Contract Tower,0,0,0,0,0,0,0,124,0,124,0,0,124,0,124,238,0,238,362
03/18/2023,WHP,CA,AWP,WE,Federal Contract Tower,0,0,0,0,0,0,0,154,0,154,0,0,154,0,154,214,0,214,368
03/19/2023,WHP,CA,AWP,WE,Federal Contract Tower,0,0,1,0,1,0,0,43,0,43,0,0,44,0,44,94,0,94,138
03/20/2023,WHP,CA,AWP,WE,Federal Contract Tower,0,0,1,0,1,0,0,49,0,49,0,0,50,0,50,222,0,222,272
03/21/2023,WHP,CA,AWP,WE,Federal Contract Tower,0,0,0,0,0,0,0,11,0,11,0,0,11,0,11,0,0,0,11
03/22/2023,WHP,CA,AWP,WE,Federal Contract Tower,0,0,1,0,1,0,0,30,0,30,0,0,31,0,31,20,0,20,51
03/23/2023,WHP,CA,AWP,WE,Federal Contract Tower,0,0,0,0,0,0,0,71,0,71,0,0,71,0,71,174,0,174,245
03/24/2023,WHP,CA,AWP,WE,Federal Contract Tower,0,0,0,0,0,0,0,64,0,64,0,0,64,0,64,20,0,20,84
03/25/2023,WHP,CA,AWP,WE,Federal Contract Tower,0,0,0,0,0,0,0,198,0,198,0,0,198,0,198,106,0,106,304
03/26/2023,WHP,CA,AWP,WE,Federal Contract Tower,0,0,0,0,0,0,0,28,0,28,0,0,28,0,28,8,0,8,36
03/27/2023,WHP,CA,AWP,WE,Federal Contract Tower,0,0,1,0,1,0,0,99,0,99,0,0,100,0,100,92,0,92,192
03/28/2023,WHP,CA,AWP,WE,Federal Contract Tower,0,0,0,0,0,0,0,127,0,127,0,0,127,0,127,94,0,94,221
03/29/2023,WHP,CA,AWP,WE,Federal Contract Tower,0,0,0,0,0,0,0,46,0,46,0,0,46,0,46,22,0,22,68
03/30/2023,WHP,CA,AWP,WE,Federal Contract Tower,0,0,0,0,0,0,0,67,0,67,0,0,67,0,67,110,0,110,177
03/31/2023,WHP,CA,AWP,WE,Federal Contract Tower,0,0,0,0,0,0,0,164,0,164,0,0,164,0,164,296,0,296,460
04/01/2023,WHP,CA,AWP,WE,Federal Contract Tower,0,0,0,0,0,0,0,222,0,222,0,0,222,0,222,146,0,146,368
04/02/2023,WHP,CA,AWP,WE,Federal Contract Tower,0,0,0,0,0,0,0,151,0,151,0,0,151,0,151,212,0,212,363
04/03/2023,WHP,CA,AWP,WE,Federal Contract Tower,0,0,0,0,0,0,0,28,0,28,0,0,28,0,28,42,0,42,70
04/04/2023,WHP,CA,AWP,WE,Federal Contract Tower,0,0,0,0,0,0,0,62,0,62,0,0,62,0,62,30,0,30,92
04/05/2023,WHP,CA,AWP,WE,Federal Contract Tower,0,0,1,0,1,0,0,141,0,141,0,0,142,0,142,184,0,184,326
04/06/2023,WHP,CA,AWP,WE,Federal Contract Tower,0,0,0,0,0,0,0,140,0,140,0,0,140,0,140,268,0,268,408
04/07/2023,WHP,CA,AWP,WE,Federal Contract Tower,0,0,0,0,0,0,0,134,0,134,0,0,134,0,134,194,0,194,328
04/08/2023,WHP,CA,AWP,WE,Federal Contract Tower,0,0,0,0,0,0,0,170,0,170,0,0,170,0,170,178,0,178,348
04/09/2023,WHP,CA,AWP,WE,Federal Contract Tower,0,0,2,0,2,0,0,109,0,109,0,0,111,0,111,190,0,190,301
04/10/2023,WHP,CA,AWP,WE,Federal Contract Tower,0,0,1,0,1,0,0,89,0,89,0,0,90,0,90,196,0,196,286
04/11/2023,WHP,CA,AWP,WE,Federal Contract Tower,0,0,0,0,0,0,0,97,0,97,0,0,97,0,97,230,0,230,327
04/12/2023,WHP,CA,AWP,WE,Federal Contract Tower,0,0,11,0,11,0,0,12,0,12,0,0,23,0,23,10,0,10,33
04/13/2023,WHP,CA,AWP,WE,Federal Contract Tower,0,0,4,0,4,0,0,35,0,35,0,0,39,0,39,40,0,40,79
04/14/2023,WHP,CA,AWP,WE,Federal Contract Tower,0,0,3,0,3,0,0,94,0,94,0,0,97,0,97,174,0,174,271
04/15/2023,WHP,CA,AWP,WE,Federal Contract Tower,0,0,1,0,1,0,0,163,0,163,0,0,164,0,164,162,0,162,326
04/16/2023,WHP,CA,AWP,WE,Federal Contract Tower,0,0,1,0,1,0,0,145,0,145,0,0,146,0,146,214,0,214,360
04/17/2023,WHP,CA,AWP,WE,Federal Contract Tower,0,0,12,0,12,0,0,42,0,42,0,0,54,0,54,120,0,120,174
04/18/2023,WHP,CA,AWP,WE,Federal Contract Tower,0,0,2,0,2,0,0,89,0,89,0,0,91,0,91,200,0,200,291
04/19/2023,WHP,CA,AWP,WE,Federal Contract Tower,0,0,0,0,0,0,0,83,0,83,0,0,83,0,83,154,0,154,237
04/20/2023,WHP,CA,AWP,WE,Federal Contract Tower,0,0,1,0,1,0,0,112,0,112,0,0,113,0,113,214,0,214,327
04/21/2023,WHP,CA,AWP,WE,Federal Contract Tower,0,0,1,0,1,0,0,157,0,157,0,0,158,0,158,304,0,304,462
04/22/2023,WHP,CA,AWP,WE,Federal Contract Tower,0,0,0,0,0,0,0,172,0,172,0,0,172,0,172,126,0,126,298
04/23/2023,WHP,CA,AWP,WE,Federal Contract Tower,0,0,1,0,1,0,0,168,0,168,0,0,169,0,169,272,0,272,441
04/24/2023,WHP,CA,AWP,WE,Federal Contract Tower,0,0,3,0,3,0,0,69,0,69,0,0,72,0,72,176,0,176,248
04/25/2023,WHP,CA,AWP,WE,Federal Contract Tower,0,0,3,0,3,0,0,121,0,121,0,0,124,0,124,354,0,354,478
04/26/2023,WHP,CA,AWP,WE,Federal Contract Tower,0,0,2,0,2,0,0,142,0,142,0,0,144,0,144,262,0,262,406
04/27/2023,WHP,CA,AWP,WE,Federal Contract Tower,0,0,0,0,0,0,0,108,0,108,0,0,108,0,108,150,0,150,258
04/28/2023,WHP,CA,AWP,WE,Federal Contract Tower,0,0,1,0,1,0,0,113,0,113,0,0,114,0,114,170,0,170,284
04/29/2023,WHP,CA,AWP,WE,Federal Contract Tower,0,0,3,0,3,0,0,102,0,102,0,0,105,0,105,242,0,242,347
04/30/2023,WHP,CA,AWP,WE,Federal Contract Tower,0,0,27,0,27,0,0,93,0,93,0,0,120,0,120,180,0,180,300
05/01/2023,WHP,CA,AWP,WE,Federal Contract Tower,0,0,4,0,4,0,0,46,0,46,0,0,50,0,50,126,0,126,176
05/02/2023,WHP,CA,AWP,WE,Federal Contract Tower,0,0,3,0,3,0,0,91,0,91,0,0,94,0,94,176,0,176,270
05/03/2023,WHP,CA,AWP,WE,Federal Contract Tower,0,0,0,0,0,0,0,91,0,91,0,0,91,0,91,152,0,152,243
05/04/2023,WHP,CA,AWP,WE,Federal Contract Tower,0,0,1,0,1,0,0,45,0,45,0,0,46,0,46,32,0,32,78
05/05/2023,WHP,CA,AWP,WE,Federal Contract Tower,0,0,0,0,0,0,0,129,0,129,0,0,129,0,129,354,0,354,483
05/06/2023,WHP,CA,AWP,WE,Federal Contract Tower,0,0,2,0,2,0,0,124,0,124,0,0,126,0,126,284,0,284,410
05/07/2023,WHP,CA,AWP,WE,Federal Contract Tower,0,0,1,0,1,0,0,151,0,151,0,0,152,0,152,318,0,318,470
05/08/2023,WHP,CA,AWP,WE,Federal Contract Tower,0,0,0,0,0,0,0,103,0,103,0,0,103,0,103,244,0,244,347
05/09/2023,WHP,CA,AWP,WE,Federal Contract Tower,0,0,7,0,7,0,0,79,0,79,0,0,86,0,86,292,0,292,378
05/10/2023,WHP,CA,AWP,WE,Federal Contract Tower,0,0,1,0,1,0,0,126,0,126,0,0,127,0,127,332,0,332,459
05/11/2023,WHP,CA,AWP,WE,Federal Contract Tower,0,0,4,0,4,0,0,123,0,123,0,0,127,0,127,228,0,228,355
05/12/2023,WHP,CA,AWP,WE,Federal Contract Tower,0,0,0,0,0,0,0,107,0,107,0,0,107,0,107,256,0,256,363
05/13/2023,WHP,CA,AWP,WE,Federal Contract Tower,0,0,1,0,1,0,0,136,0,136,0,0,137,0,137,148,0,148,285
05/14/2023,WHP,CA,AWP,WE,Federal Contract Tower,0,0,2,0,2,0,0,76,0,76,0,0,78,0,78,136,0,136,214
05/15/2023,WHP,CA,AWP,WE,Federal Contract Tower,0,0,2,0,2,0,0,80,0,80,0,0,82,0,82,188,0,188,270
05/16/2023,WHP,CA,AWP,WE,Federal Contract Tower,0,0,0,0,0,0,0,125,0,125,0,0,125,0,125,234,0,234,359
05/17/2023,WHP,CA,AWP,WE,Federal Contract Tower,0,0,3,0,3,0,0,131,0,131,0,0,134,0,134,214,0,214,348
05/18/2023,WHP,CA,AWP,WE,Federal Contract Tower,0,0,2,0,2,0,0,102,0,102,0,0,104,0,104,168,0,168,272
05/19/2023,WHP,CA,AWP,WE,Federal Contract Tower,0,0,41,0,41,0,0,7,0,7,0,0,48,0,48,38,0,38,86
05/20/2023,WHP,CA,AWP,WE,Federal Contract Tower,0,0,8,0,8,0,0,112,0,112,0,0,120,0,120,148,0,148,268
05/21/2023,WHP,CA,AWP,WE,Federal Contract Tower,0,0,32,0,32,0,0,101,0,101,0,0,133,0,133,212,0,212,345
05/22/2023,WHP,CA,AWP,WE,Federal Contract Tower,0,0,13,0,13,0,0,51,0,51,0,0,64,0,64,214,0,214,278
05/23/2023,WHP,CA,AWP,WE,Federal Contract Tower,0,0,7,0,7,0,0,25,0,25,0,0,32,0,32,0,0,0,32
05/24/2023,WHP,CA,AWP,WE,Federal Contract Tower,0,0,10,0,10,0,0,48,0,48,0,0,58,0,58,92,0,92,150
05/25/2023,WHP,CA,AWP,WE,Federal Contract Tower,0,0,6,0,6,0,0,99,0,99,0,0,105,0,105,210,0,210,315
05/26/2023,WHP,CA,AWP,WE,Federal Contract Tower,0,0,2,0,2,0,0,127,0,127,0,0,129,0,129,364,0,364,493
05/27/2023,WHP,CA,AWP,WE,Federal Contract Tower,0,0,5,0,5,0,0,187,0,187,0,0,192,0,192,202,0,202,394
05/28/2023,WHP,CA,AWP,WE,Federal Contract Tower,0,0,13,0,13,0,0,36,0,36,0,0,49,0,49,136,0,136,185
05/29/2023,WHP,CA,AWP,WE,Federal Contract Tower,0,0,9,0,9,0,0,64,0,64,0,0,73,0,73,190,0,190,263
05/30/2023,WHP,CA,AWP,WE,Federal Contract Tower,0,0,6,0,6,0,0,116,0,116,0,0,122,0,122,356,0,356,478
05/31/2023,WHP,CA,AWP,WE,Federal Contract Tower,0,0,5,0,5,0,0,80,0,80,0,0,85,0,85,366,0,366,451
06/01/2023,WHP,CA,AWP,WE,Federal Contract Tower,0,0,4,0,4,0,0,100,0,100,0,0,104,0,104,254,0,254,358
06/02/2023,WHP,CA,AWP,WE,Federal Contract Tower,0,0,2,0,2,0,0,112,0,112,0,0,114,0,114,254,0,254,368
06/03/2023,WHP,CA,AWP,WE,Federal Contract Tower,0,0,4,0,4,0,0,176,0,176,0,0,180,0,180,274,0,274,454
06/04/2023,WHP,CA,AWP,WE,Federal Contract Tower,0,0,6,0,6,0,0,112,0,112,0,0,118,0,118,274,0,274,392
06/05/2023,WHP,CA,AWP,WE,Federal Contract Tower,0,0,9,0,9,0,0,11,0,11,0,0,20,0,20,4,0,4,24
06/06/2023,WHP,CA,AWP,WE,Federal Contract Tower,0,0,6,0,6,0,0,134,0,134,0,0,140,0,140,370,0,370,510
06/07/2023,WHP,CA,AWP,WE,Federal Contract Tower,0,0,3,0,3,0,0,92,0,92,0,0,95,0,95,294,0,294,389
06/09/2023,WHP,CA,AWP,WE,Federal Contract Tower,0,0,15,0,15,0,0,40,0,40,0,0,55,0,55,226,0,226,281
06/10/2023,WHP,CA,AWP,WE,Federal Contract Tower,0,0,4,0,4,0,0,33,0,33,0,0,37,0,37,320,0,320,357
06/11/2023,WHP,CA,AWP,WE,Federal Contract Tower,0,0,9,0,9,0,0,49,0,49,0,0,58,0,58,332,0,332,390
06/12/2023,WHP,CA,AWP,WE,Federal Contract Tower,0,0,5,0,5,0,0,81,0,81,0,0,86,0,86,320,0,320,406
06/13/2023,WHP,CA,AWP,WE,Federal Contract Tower,0,0,6,0,6,0,0,114,0,114,0,0,120,0,120,298,0,298,418
06/14/2023,WHP,CA,AWP,WE,Federal Contract Tower,0,0,6,0,6,0,0,77,0,77,0,0,83,0,83,178,0,178,261
06/15/2023,WHP,CA,AWP,WE,Federal Contract Tower,0,0,7,0,7,0,0,45,0,45,0,0,52,0,52,76,0,76,128
06/16/2023,WHP,CA,AWP,WE,Federal Contract Tower,0,0,5,0,5,0,0,66,0,66,0,0,71,0,71,76,0,76,147
06/17/2023,WHP,CA,AWP,WE,Federal Contract Tower,0,0,1,0,1,0,0,162,0,162,0,0,163,0,163,168,0,168,331
06/18/2023,WHP,CA,AWP,WE,Federal Contract Tower,0,0,5,0,5,0,0,51,0,51,0,0,56,0,56,160,0,160,216
06/19/2023,WHP,CA,AWP,WE,Federal Contract Tower,0,0,6,0,6,0,0,63,0,63,0,0,69,0,69,228,0,228,297
06/20/2023,WHP,CA,AWP,WE,Federal Contract Tower,0,0,1,0,1,0,0,136,0,136,0,0,137,0,137,324,0,324,461
06/21/2023,WHP,CA,AWP,WE,Federal Contract Tower,0,0,2,0,2,0,0,146,0,146,0,0,148,0,148,300,0,300,448
06/22/2023,WHP,CA,AWP,WE,Federal Contract Tower,0,0,1,0,1,0,0,107,0,107,0,0,108,0,108,210,0,210,318
06/23/2023,WHP,CA,AWP,WE,Federal Contract Tower,0,0,2,0,2,0,0,114,0,114,0,0,116,0,116,180,0,180,296
06/24/2023,WHP,CA,AWP,WE,Federal Contract Tower,0,0,4,0,4,0,0,207,0,207,0,0,211,0,211,108,0,108,319
06/25/2023,WHP,CA,AWP,WE,Federal Contract Tower,0,0,5,0,5,0,0,132,0,132,0,0,137,0,137,148,0,148,285
06/26/2023,WHP,CA,AWP,WE,Federal Contract Tower,0,0,0,0,0,0,0,117,0,117,0,0,117,0,117,198,0,198,315
06/27/2023,WHP,CA,AWP,WE,Federal Contract Tower,0,0,0,0,0,0,0,117,0,117,0,0,117,0,117,272,0,272,389
06/28/2023,WHP,CA,AWP,WE,Federal Contract Tower,0,0,2,0,2,0,0,150,0,150,0,0,152,0,152,258,0,258,410
06/29/2023,WHP,CA,AWP,WE,Federal Contract Tower,0,0,2,0,2,0,0,112,0,112,0,0,114,0,114,208,0,208,322
06/30/2023,WHP,CA,AWP,WE,Federal Contract Tower,0,0,1,0,1,0,0,136,0,136,0,0,137,0,137,266,0,266,403
07/01/2023,WHP,CA,AWP,WE,Federal Contract Tower,0,0,4,0,4,0,0,102,0,102,0,0,106,0,106,150,0,150,256
07/02/2023,WHP,CA,AWP,WE,Federal Contract Tower,0,0,1,0,1,0,0,110,0,110,0,0,111,0,111,214,0,214,325
07/03/2023,WHP,CA,AWP,WE,Federal Contract Tower,0,0,1,0,1,0,0,105,0,105,0,0,106,0,106,263,0,263,369
07/04/2023,WHP,CA,AWP,WE,Federal Contract Tower,0,0,0,0,0,0,0,102,0,102,0,0,102,0,102,166,0,166,268
07/05/2023,WHP,CA,AWP,WE,Federal Contract Tower,0,0,4,0,4,0,0,102,0,102,0,0,106,0,106,184,0,184,290
07/06/2023,WHP,CA,AWP,WE,Federal Contract Tower,0,0,0,0,0,0,0,102,0,102,0,0,102,0,102,172,0,172,274
07/07/2023,WHP,CA,AWP,WE,Federal Contract Tower,0,0,3,0,3,0,0,109,0,109,0,0,112,0,112,160,0,160,272
07/08/2023,WHP,CA,AWP,WE,Federal Contract Tower,0,0,4,0,4,0,0,119,0,119,0,0,123,0,123,140,0,140,263
07/09/2023,WHP,CA,AWP,WE,Federal Contract Tower,0,0,2,0,2,0,0,110,0,110,0,0,112,0,112,166,0,166,278
07/10/2023,WHP,CA,AWP,WE,Federal Contract Tower,0,0,0,0,0,0,0,115,0,115,0,0,115,0,115,154,0,154,269
07/11/2023,WHP,CA,AWP,WE,Federal Contract Tower,0,0,0,0,0,0,0,114,0,114,0,0,114,0,114,266,0,266,380
07/12/2023,WHP,CA,AWP,WE,Federal Contract Tower,0,0,1,0,1,0,0,130,0,130,0,0,131,0,131,196,0,196,327
07/13/2023,WHP,CA,AWP,WE,Federal Contract Tower,0,0,3,0,3,0,0,136,0,136,0,0,139,0,139,234,0,234,373
07/14/2023,WHP,CA,AWP,WE,Federal Contract Tower,0,0,0,0,0,0,0,116,0,116,0,0,116,0,116,176,0,176,292
07/15/2023,WHP,CA,AWP,WE,Federal Contract Tower,0,0,0,0,0,0,0,131,0,131,0,0,131,0,131,126,0,126,257
07/16/2023,WHP,CA,AWP,WE,Federal Contract Tower,0,0,0,0,0,0,0,102,0,102,0,0,102,0,102,176,0,176,278
07/17/2023,WHP,CA,AWP,WE,Federal Contract Tower,0,0,0,0,0,0,0,84,0,84,0,0,84,0,84,70,0,70,154
07/18/2023,WHP,CA,AWP,WE,Federal Contract Tower,0,0,0,0,0,0,0,131,0,131,0,0,131,0,131,306,0,306,437
07/19/2023,WHP,CA,AWP,WE,Federal Contract Tower,0,0,3,0,3,0,0,137,0,137,0,0,140,0,140,310,0,310,450
07/20/2023,WHP,CA,AWP,WE,Federal Contract Tower,0,0,1,0,1,0,0,139,0,139,0,0,140,0,140,172,0,172,312
07/21/2023,WHP,CA,AWP,WE,Federal Contract Tower,0,0,0,0,0,0,0,140,0,140,0,0,140,0,140,182,0,182,322
07/22/2023,WHP,CA,AWP,WE,Federal Contract Tower,0,0,0,0,0,0,0,197,0,197,0,0,197,0,197,104,0,104,301
07/23/2023,WHP,CA,AWP,WE,Federal Contract Tower,0,0,0,0,0,0,0,88,0,88,0,0,88,0,88,158,0,158,246
07/24/2023,WHP,CA,AWP,WE,Federal Contract Tower,0,0,1,0,1,0,0,107,0,107,0,0,108,0,108,258,0,258,366
07/25/2023,WHP,CA,AWP,WE,Federal Contract Tower,0,0,0,0,0,0,0,104,0,104,0,0,104,0,104,214,0,214,318
07/26/2023,WHP,CA,AWP,WE,Federal Contract Tower,0,0,1,0,1,0,0,131,0,131,0,0,132,0,132,232,0,232,364
07/27/2023,WHP,CA,AWP,WE,Federal Contract Tower,0,0,3,0,3,0,0,116,0,116,0,0,119,0,119,140,0,140,259
07/28/2023,WHP,CA,AWP,WE,Federal Contract Tower,0,0,0,0,0,0,0,86,0,86,0,0,86,0,86,174,0,174,260
07/29/2023,WHP,CA,AWP,WE,Federal Contract Tower,0,0,0,0,0,0,0,105,0,105,0,0,105,0,105,114,0,114,219
07/30/2023,WHP,CA,AWP,WE,Federal Contract Tower,0,0,1,0,1,0,0,92,0,92,0,0,93,0,93,170,0,170,263
07/31/2023,WHP,CA,AWP,WE,Federal Contract Tower,0,0,0,0,0,0,0,67,0,67,0,0,67,0,67,248,0,248,315
08/01/2023,WHP,CA,AWP,WE,Federal Contract Tower,0,0,0,0,0,0,0,118,0,118,0,0,118,0,118,328,0,328,446
08/02/2023,WHP,CA,AWP,WE,Federal Contract Tower,0,0,1,0,1,0,0,125,0,125,0,0,126,0,126,288,0,288,414
08/03/2023,WHP,CA,AWP,WE,Federal Contract Tower,0,0,2,0,2,0,0,141,0,141,0,0,143,0,143,168,0,168,311
08/05/2023,WHP,CA,AWP,WE,Federal Contract Tower,0,0,0,0,0,0,0,112,0,112,0,0,112,0,112,146,0,146,258
08/06/2023,WHP,CA,AWP,WE,Federal Contract Tower,0,0,1,0,1,0,0,120,0,120,0,0,121,0,121,174,0,174,295
08/07/2023,WHP,CA,AWP,WE,Federal Contract Tower,0,0,0,0,0,0,0,89,0,89,0,0,89,0,89,178,0,178,267
08/08/2023,WHP,CA,AWP,WE,Federal Contract Tower,0,0,0,0,0,0,0,133,0,133,0,0,133,0,133,250,0,250,383
08/09/2023,WHP,CA,AWP,WE,Federal Contract Tower,0,0,2,0,2,0,0,119,0,119,0,0,121,0,121,248,0,248,369
08/10/2023,WHP,CA,AWP,WE,Federal Contract Tower,0,0,3,0,3,0,0,62,0,62,0,0,65,0,65,60,0,60,125
08/11/2023,WHP,CA,AWP,WE,Federal Contract Tower,0,0,4,0,4,0,0,85,0,85,0,0,89,0,89,176,0,176,265
08/12/2023,WHP,CA,AWP,WE,Federal Contract Tower,0,0,0,0,0,0,0,114,0,114,0,0,114,0,114,228,0,228,342
08/13/2023,WHP,CA,AWP,WE,Federal Contract Tower,0,0,3,0,3,0,0,175,0,175,0,0,178,0,178,244,0,244,422
08/14/2023,WHP,CA,AWP,WE,Federal Contract Tower,0,0,3,0,3,0,0,92,0,92,0,0,95,0,95,310,0,310,405
08/15/2023,WHP,CA,AWP,WE,Federal Contract Tower,0,0,0,0,0,0,0,114,0,114,0,0,114,0,114,230,0,230,344
08/16/2023,WHP,CA,AWP,WE,Federal Contract Tower,0,0,4,0,4,0,0,93,0,93,0,0,97,0,97,162,0,162,259
08/17/2023,WHP,CA,AWP,WE,Federal Contract Tower,0,0,0,0,0,0,0,61,0,61,0,0,61,0,61,80,0,80,141
08/18/2023,WHP,CA,AWP,WE,Federal Contract Tower,0,0,3,0,3,0,0,127,0,127,0,0,130,0,130,238,0,238,368
08/19/2023,WHP,CA,AWP,WE,Federal Contract Tower,0,0,2,0,2,0,0,108,0,108,0,0,110,0,110,214,0,214,324
08/20/2023,WHP,CA,AWP,WE,Federal Contract Tower,0,0,4,0,4,0,0,0,0,0,0,0,4,0,4,0,0,0,4
08/21/2023,WHP,CA,AWP,WE,Federal Contract Tower,0,0,1,0,1,0,0,52,0,52,0,0,53,0,53,120,0,120,173
08/22/2023,WHP,CA,AWP,WE,Federal Contract Tower,0,0,5,0,5,0,0,134,0,134,0,0,139,0,139,294,0,294,433
08/23/2023,WHP,CA,AWP,WE,Federal Contract Tower,0,0,0,0,0,0,0,134,0,134,0,0,134,0,134,334,0,334,468
08/24/2023,WHP,CA,AWP,WE,Federal Contract Tower,0,0,2,0,2,0,0,87,0,87,0,0,89,0,89,214,0,214,303
08/25/2023,WHP,CA,AWP,WE,Federal Contract Tower,0,0,1,0,1,0,0,94,0,94,0,0,95,0,95,316,0,316,411
08/26/2023,WHP,CA,AWP,WE,Federal Contract Tower,0,0,2,0,2,0,0,212,0,212,0,0,214,0,214,58,0,58,272
08/27/2023,WHP,CA,AWP,WE,Federal Contract Tower,0,0,5,0,5,0,0,143,0,143,0,0,148,0,148,166,0,166,314
08/28/2023,WHP,CA,AWP,WE,Federal Contract Tower,0,0,1,0,1,0,0,77,0,77,0,0,78,0,78,160,0,160,238
08/29/2023,WHP,CA,AWP,WE,Federal Contract Tower,0,0,0,0,0,0,0,66,0,66,0,0,66,0,66,138,0,138,204
08/30/2023,WHP,CA,AWP,WE,Federal Contract Tower,0,0,0,0,0,0,0,94,0,94,0,0,94,0,94,60,0,60,154
08/31/2023,WHP,CA,AWP,WE,Federal Contract Tower,0,0,4,0,4,0,0,142,0,142,0,0,146,0,146,214,0,214,360
